how about some testimonies from real health experts ?	also , who 's to say there aren 't testimonies from " real " health experts on there ?
" then the captain was gone .	then the captain came back .
the problem is simpler than that .	the problem is simple .
negative reconnaissance requirements .	pacific requirements .
so , i am dropping , for now , asking you the question : " where ' s the marx " ?	i am moving on to ask you the question : " where ' s the beef " ?
go figure you 're asking me to prove a negative ?	you 're asking me to prove a negative ?
i am ok with medical use !	i am ok with medical use ! !
the prices for everything you need have gone up due to inflation .	the prices of everything you own ie assets have gone down .
war in the middle east .	a war in the middle east .
originally posted by vienna how was it authoritarian ?	originally posted by zaf i give up .
imagine a place that 's % white and % black .	imagine a place with % men and % women .
there 's no chance of a fair trial .	there is no chance at a fair trial .
nirvana is very different than oblivion .	nirvana is not oblivion .
we in britain think differently to americans .	originally posted by zaf we in britain think differently to americans .
if you answer yes to and no to you are probably straight .	if you answer no to but yes to then you are probably straight .
the whole earth combined produces enough food for billion people .	who does it now only produce enough for billion ?
btw he had appropriate deferments for the time .	appropriate deferments for the time , eh ?
hey , blue-eyes , how 's things in london ?	* * smooches ran * * hey , blue-eyes , how 's things in london ?
but in the news broadcasts i have seen they did call him white .	but it seems it would have less " impact " if they didn 't call him white .
according to the girlfriend and zimmerman , he did .	according to zimmerman he did .
my parents have told me it is bad for you .	my teachers have told me it is bad for you .
.nazi is a slang term for the nswp .	originally posted by odins eye .nazi is a slang term for the nswp .
i oppose the death penalty .	this is why i support the death penalty .
well , whatever , you are now .	well , whatever , you 're aware of it now .
they produce nothing i can eat , wear , live in .	think about all the things you can 't " eat , wear , or live in " .
dickshot matt holliday owns .	matt holliday owns , y 'all .
people exploited the laws .	people bent the laws .
funny , i thought the same thing about some math .	and here i thought i knew me some math .
i have years of " neener neener " rights i use lettuce too .	i have years of " neener neener " rights hi wiggies !
i don 't prefix or suffix everything with " you hate jews . "	you should stop prefixing or suffixing everything with you hate jews .
i wood have asked her if she is up for a treesome .	i wood have at least asked if a threesome was out of the question .
it still makes no sense .	it 's you who makes no sense .
more expensive homes .	more expensive cars .
martin said , " why are you following me ? "	zimmerman replied , " what are you doing here ? "
although satellite intensity estimates from tafb and sab are only t. /	subjective dvorak intensity estimates from tafb and sab increased to kt .
" fairies don 't exist " - fine .	" satyrs don 't exist " - fine .
you wanna know what i find curious ?	that 's what i find curious .
when did i compare homo sexuaity with a developmental disorder ?	i compared homo phobia with a developmental disorder .
if you asked , conservatives , the numbers will be skewed to the right .	if you asked , progressives , the numbers would be skewed to the left .
you didn 't mention pfa before that one post .	i didn 't mention restraining order either .
ramblin ' rose by nat king cole we are all vessels filled with many wonders .	eye of the tiger we are all vessels filled with many wonders .
from the year prior .	warmed.c from the year prior .
still love this show .	holy poo poo , this show .
their vast properties are protected by the govt .	their great wealth is protected by the govt .
fundimental difference , please ?	fundamental difference ?
how exactly is germany being ' punished ' for the stupidity of ww ?	how exactly are they being punished ?
z stalked him down , then shot him .	you claimed zimmerman " stalked him down , then shot him " .
i 'm not outraged , i 'm disappointed .	god bless i 'm not outraged , i 'm disappointed .
we never got out of it in the first place !	where does the money come from in the first place ?
freedom of speech has consequences !	if freedom of speech has consequences then it is not free .
my parents have told me it is bad for you .	my teachers have told me it is bad for you .
if you could kill one person to save four , would you ?	as to would i kill person to save , i have no idea .
it 's not imposing morals .	it 's imposing a law .
it depends how you define extreme .	depends on how you define " extreme " .
at least mexico had a presence in california .	mexico has zero claim to california .
so yes , we do read the bible to learn about christianity .	personally i would read the bible to learn about christianity .
ah ha , ha , ha , ha , ha !	ha , ha , ha , ha , ha , ha !
and that 's why you 're yelling at me and refusing to answer my questions ?	still refusing to answer my questions ?
you have too much regulation , not too little .	you have to much intervention in free markets , not too little .
the human element you could sign lance berkman at the end of the year i guess ?	you could sign lance berkman at the end of the year i guess ?
why was the book of thomas left out of the canon ?	why would the addition of more of jesus words be left out of the canon ?
you mean , you believe the word of the mainstream media ?	you mean , you believe the word of the springhallconvert ?
we are meant to explore .	we are meant to move .
israel doesn 't give a * * * * , accept it .	that israel doesn 't giva a * * * * what anybody else thinks .
we are all vessels filled with many wonders .	i want to rock and roll by kiss we are all vessels filled with many wonders .
slutstamp ! a dear friend from ohio sent me this .	a dear friend from ohio sent me this .
and yet , the titanic story is the one that holds up to scrutiny of the evidence .	the new study shows that the titanic story does not stand up to scrutiny imo .
can he really make mone from google ad sense .	who makes money off google ad sense ?
they know that the video doesn 't show a gas chamber .	the bottom line is that the video clip doesn 't show a gas chamber .
warm , maybe record .	warmer , almost certainly a record .
" bright but scatterbrained " becomes " treat with drugs " .	" opinionated and stubborn " becomes treat with drugs " .
what is your definition of " life " ?	what 's your definition of nature ?
could be a lot of things .	could be a simple mistake .
no extortion , no bribery , no money involved he 's asking for money for his vote .	no extortion , no bribery , no money involved only class e felonies .
dr. neander 's revised version .	neander 's revised version " ?
should i just tell her how i feel ?	should i just wait it out and see how it goes ?
i. atlantic requirements .	pacific requirements .
you have no remains of a missile at the pentagon .	you have no witnesses for a missile at the pentagon .
" jane " wants me to ask the helpful party guest to pay for it .	i can 't believe she is asking you to ask the helpful party guest for money !
any woman that wants birth control can get it .	any woman that wants and abortion can get one .
is it legal to grow ?	yes , it 's legal to grow .
pressing one does not " do " english .	pressing one does send a tone .
what 's my opinion regarding the series ?	what was my opinion of firefly in the interim ?
we are all vessels filled with many wonders .	chuck close we are all vessels filled with many wonders .
does he have supporters ?	he definently has supporters .
but okay , ultimate sovereignty ?	thus , ultimate sovereignty .
that is not an answer .	no , it 's not an answer .
the nazis increases the longevity of a handgun permit from to years .	the nazis lowered the minimum age to buy a firearm from to .
but we can 't do it without help .	we can 't do it without you . "
no healthy person needs gambling .	no healthy person needs sex .
i said it wasn 't a person , in the legal sense .	if it isn 't a person , then wtf is it ?
do you see obama calling for regulation reform ?	do you see obama calling for cut , cap and balance ?
" leprechauns don 't exist " - fine .	" elves don 't exist " - fine .
got some heine and coors light i started it last night xanis .	i started it last night xanis .
iran is also a signed of the npt and the iaea .	gotta love the ek factoid that " iran is also a signed of the npt and the iaea .
" gorgons don 't exist " - fine .	" satyrs don 't exist " - fine .
best way to get money out is to get rid of lobby , all of it .	best way to turn it on its head is to get money out .
i have years of " neener neener " rights usually i get pretty decent care .	i have years of " neener neener " rights they are crack ups .
dutchy has anyone heard from dutchy ?	@ nickfun , has anyone heard from dutchy ?
commodity expanded value-form , .	elementary commodity-capital value-form .
you are a christian .	therefore you are not a christian .
and the simple fact today ?	i repeat : and the simple fact today ?
morals have absolutely nothing to do with it !	and morals and honesty have everything to do with it .
" oh , you 're such a good person !	you 're such a bad person ! "
fern i think stories like this are stupid .	- wolf i think stories like this are stupid .
cyclone formation is not expected during the next hours .	tropical cyclone formation is not expected .
do you not understand what that string of words means ?	do you not understand what the word ' led ' implies ?
there is no freedom of religion .	there is no freedom of speech .
originally posted by solinvictus the messahe of all the scriptures is oneness .	originally posted by solinvictus ah .
how long after the obliteration should the kid return to school ?	how long after the obliteration should it no longer bother the kid ?
a man and a woman are different yes .	men and women are different yes ?
double jeopardy actually enforces a jury nullification .	as far as legality goes i can use jury nullification .
facilitator : show me the smart child .	facilitator : and why is she the dumb child ?
religious fiction isn 't that redundant and repetetive ?	isn 't that redundant and repetetive ?
originally posted by anabelle what 's wrong with that ?	originally posted by vienna to ' say ' what ?
cracklin ' rosie by neil diamond we are all vessels filled with many wonders .	jingle bell rock by bobby helm we are all vessels filled with many wonders .
some people have complete confidence in the people running these institutions .	other people have no confidence at all in teh people running these institutions .
loose change started out as a work of fiction .	it finished as a work of fiction .
if it wasn 't a life , then it would not be able to be born .	if it wasn 't alive , then it would miscarriage on it 's own .
gl , terral that is absolutely amazing .	hi ollie : that is absolutely amazing .
lets assume we have % white and % black .	imagine a place that 's % white and % black .
freedom of speech has consequences !	if freedom of speech has consequences then it is not free .
" fairies don 't exist " - fine .	" leprechauns don 't exist " - fine .
if so , state that is why they 're not true .	please , what about them are not true .
-not- talking about it ' and ' -not- doing anything .	is even worse than talking about it and not doing anything .
" being against nukes " does not mean " not wanting to use nukes " .	" being against using nukes " means " not wanting to use nukes " .
my niece is married to a black man .	my great niece is half black .
the uk population is just over million .	the japanese population is nearly million .
i shot the sheriff we are all vessels filled with many wonders .	we are all vessels filled with many wonders .
i hope this is nothing .	i hope everything is ok !
the money i spent adopting velociraptor .	those may be my top . the money i spent adopting velociraptor .
so , you actually believe every word of what terral wrote ?	gl , terral hi corn : so , you actually believe every word of what terral wrote ?
what isn 't how what was sold ?	it 's not how it was sold , gb .
i know i 'd hate to be him .	i 'd hate to be him too .
there were no weapons .	of course there were no weapons .
it 's so stupid that it just has to be true .	it 's amusing to think it even might be true .
personal responsibility much ?	again , personal responsibility .
do you notice the nonsensical things you are saying ?	and to be fair , do you notice the nonsensical things you are saying ?
i guess i pulled it out of the census 's rear end in a top hat .	does the census have an rear end in a top hat ?
how is this slanted against bush ? ?	where is the slant against bush ?
if it wasn 't bollocks it wouldn 't be homeopathy .	that 's simple logic if it wasn 't bollocks it wouldn 't be homeopathy .
i 've never accused him of over-milligraming , nothing .	i 've never accused him of doctoring a baseball .
the bailout was bigger than tarp bloomberg news .	the bailout was bigger than tarp this title is misleading .
my parents have told me it is bad for you .	officers have told me its bad for you .
his position is that it is the individual 's risk to assume .	his position is the way it is currently .
i. atlantic requirements .	pacific requirements .
read more : you have never met anyone that is pro-abortion ?	you have never met anyone that is pro-abortion ?
i have no problem with those that have money !	i have many problems with these men , way to many to state here !
nixon , ford and carter shut down the oilfields ?	no has has shut down the oil fields .
i don 't want a president who ' cares ' .	i don 't want a president who is charasmatic .
it doesn 't have to be braindead .	i don 't have a proposed model .
no missile evidence .	no missile witnesses .
my teachers have told me it is bad for you .	officers have told me its bad for you .
my gosh , i 'm the one with the pregnancy ticker .	i have the pregnancy ticker .
then he is not omnipotent .	then he is malevolent .
tin foil hat for the dog face , what size do u wear ?	tin foil hat for the sarg , what size do u wear ?
like this year old who was shot dead in a marijuana-related crime .	or the year old boy shot dead with automatic weapons by marijuana dealers .
if you leap up to make a hit , you 're getting a penalty .	if your stick hits a guy in the face , you 're getting a penalty .
all of the electrical energy comes from the battery .	all of the electrical energy ultimately comes from the alternator .
do you know how many passengers testified or what they said ?	how many passengers said they saw an iceberg ?
imagine a place with % men and % women .	imagine a place that 's % white and % black .
scenario a assumes that the co growth rate accelerates by . % / yr .	it assumes that methane growth rate accelerates by . % / yr .
they have actually showed a cooling trend since due to the recent decline .	get a cooling trend from because of the recent decline .
we are all vessels filled with many wonders .	landon memory from cats we are all vessels filled with many wonders .
to repeat : they are not as sovereign as they were before .	they are not as sovereign as they were before .
out of touch and completely untrustworthy , however , wouldn 't .	out of touch and untrustworthy ?
it is mostly just the dutch .	in fact , it 's just the dutch .
we 're talking about angels and common pins again , right ?	@ lustig andrei , we 're talking about angels and common pins again , right ?
claims about trayvon 's character and when did i do that ?	slanted blogs and when did i do that ?
% how much money does pp take in for abortion services ?	how much is spent on abortions services ?
why did that transaction take place .	did the transaction take place ?
there is no more egg cell post-fertilization .	there is no more sperm cell .
lacey - welcome back !	anyway , welcome back .
more factchecking : i don 't know why anyone is making a fuss over the $ , bet .	i don 't know why anyone is making a fuss over the $ , bet .
if you haven 't made any claims , then just say so .	i haven 't made any claims .
no thatcherite can ever call themselves a libertarian .	ergo it offends me when thatcherites call themselves libertarian .
the problem isn 't who has money .	the problem is who doesn 't have money .
but do you actually believe there was an iceberg in those waters ?	i don 't believe there was any iceberg at all anywhere near the titanic .
not astros or orioles bad gameday for the orioles game is frozen for me .	gameday for the orioles game is frozen for me .
if so , alot of cops should take presciption drugs .	if so , alot of inventors , writers should take prescription drugs ..
tell us what the charges were .	yes what are his charges .
those are partial psychopaths .	was ted bundy a partial psychopath ?
those who ignore history are doomed to repeat it .	ooo strike two those who ignore history are doomed to repeat it .
this is not a war deployment .	its not an official deployment .
nutrax the plural of anecdote is not data did gentlemen need chaperones ?	nutrax the plural of anecdote is not data
alright just got in .	not well alright just got in .
h and i both read the books and thought the movie moved so quickly .	i haven 't read the books , but i saw the movie today .
that 's not the moloch scene , though .	this is the moloch scene .
@ lustig andrei , so lyndon johnson and john kennedy were compatible ?	@ edgarblythe , so lyndon johnson and john kennedy were compatible ?
you need to make up your mind .	you need to polish up on your logic skills .
the one that has walks home afterwards and goes to sleep .	the one that has three walks home and beats his wife .
- admin drpizza and i 'd forgotten what a whiny little bed wetter you are .	and i 'd forgotten what a whiny little bed wetter you are .
the argument was " albert einstein didn 't go to college " .	omg , " einstein didn 't go to college . "
capital gains , top rate : percent .	income tax , top rate : percent .
bienging is unaccptable .	being drunk is unacceptable .
he hasn 't been funny in years .	he hasn 't been funny since larry bud melman was on the show .
if the universe has an explanation of its existence , that explanation is god .	therefore , the universe has an explanation of its existence .
what do we get in return for doing the fighting for them ?	------ ----------- what do we get in return for doing the fighting for them ?
it wouldn 't stop joke marriages .	and i don 't fight for marriage .
if they were jews , i would call them jews .	if they were catholics , i would call them catholics .
she was a great lady .	she was a nice lady .
he 's not wealthy because he 's successful .	why hate people because they are successful ?
not as irritated as you .	you seem as irritated as henry .
it 's a common sense / deductive reasoning thing .	hilited your common sense / deductive reasoning thing .
you already did that - we have a muslim in office right now .	-cryptolutheran no . we have a christian in office right now .
i said she has not ever had to be a part of any workforce .	ann romney has never had to get out and be a part of the workforce .
dreamtech never been ejaculated on as far as i know .	it has never been ejaculated on as far as i know .
i didn 't say we had gotten soft since / rand .	i said you had gotten soft .
we all believe that we are getting what we expect .	most times , % of the time , we are getting what we expect .
despicable ben , stop trying to find excuses for the man .	ben , stop trying to find excuses for the man .
unless it 's different in different countries ?	so , short form , yes , it probably is different in different countries .
the new study does not support your claim .	the physical evidence does not support your claim .
he said at every level .	but he said every level .
morals do not exist , so technically nothing can be morally wrong .	i ask again if god does not exist can anything be morally wrong ?
i thought that was mostly just the dutch .	it is mostly just the dutch .
toyland by johnny mathis we are all vessels filled with many wonders .	eye of the tiger we are all vessels filled with many wonders .
let 's let this play out in court .	nothing is stopping this thing from playing out in court .
being in a gang isnt a crime .	commiting a crime in a gang is a crime .
i 'd offer iran a deal .	chuck i 'd offer iran a deal .
yes , they are both different .	opinions are different .
it 's not imposing morals .	it 's imposing a law .
has annie ever used her sexuality like that ?	one word : zombies has annie ever used her sexuality like that ?
pure communism : you have two cows .	libertarian / anarcho-capitalism : you have two cows .
you should put scientists on a pedestal .	why do people like you put scientist on a pedestal ?
what are they trying to hide ?	i then asked : what are they trying to hide ?
that would make you partially responsible for their death .	that would make you a sort of accessory , i think .
" would you like to pay for others health care ? "	" would you like to wear your seatbelt ? "
they are not as sovereign as they were before .	to repeat : they are not as sovereign as they were before .
i don 't see obama as the lesser of two evils .	i don 't see him as evil at all .
or this one by jim croce we are all vessels filled with many wonders .	we are all vessels filled with many wonders .
the point is an unarmed child was murdered .	the point is an unarmed child was murdered who was black .
zimmerman replied , " what are you doing here ? "	martin said , " why are you following me ? "
irreligion that does that i have a problem .	religion that doesn 't do that i don 't have a problem with .
if i 'm angry , it will show up in one of those scans ..	if i 'm hyper active , it will show up in one of those scans ..
if you want to buy $ billion in xyz inc. common stock , who cares ?	if you want to buy a house or a suv , again , who cares ?
billion . everyone in the world at mexico 's current prosperity level .	everyone in the world at the current " prosperity " level of northwest africa .
if you answer yes to and no to you are probably straight .	if you answer no to but yes to then you are probably straight .
sometimes i fantasize about having power .	sometimes i , too , fantasise about bending people before my demented will .
my parents have told me it is bad for you .	my sheriff has told me its bad for you .
atlas shrugged it 's also a stellar performer in terms of blithering idiocy .	it 's also a stellar performer in terms of blithering idiocy .
how would martin not know that that was not the case ?	how would martin or anyone else know his intentions based on his actions ?
regulation get the government into everything .	" get the government into everything ? "
it 's a common sense / deductive reasoning thing .	hilited your common sense / deductive reasoning thing .
yes , i 've assumed that all packaging would be recyclable in my argument .	i 've assumed this as well in my argument .
jury nullification does not mean that a law is unconstuitutional .	jury nullification means a law isn 't constitutional ?
it 's just a bunch of cells .	i 'm " a bunch of cells . "
mann 's work was all about math .	mann 's work and the hs was all about tree rings .
i 'm so sorry to hear this kelly .	i 'm so sorry , kelly .
i don 't like flavored beers .	i don 't like many flavored drinks .
i hope everything is ok !	i hope your lo is ok .
any woman that wants birth control can get it .	any woman that wants and abortion can get one .
s as you wish : do you see hitler killing jews ?	do you see hitler killing jews ?
and i 'm your friend mitt .	your good friend mitt .
it means its an option .	doesnt mean its a bad option .
i think you need to reread what i wrote .	you need to reread what i wrote .
lets assume we have % white and % black .	imagine a place that 's % white and % black .
mom busted in and said , " what 's that noise ? "	my kids busted in and said ' whats that dad ? '
my best , kutte my ex-fiance wouldn 't use the va or navy doctor 's .	jay my ex-fiance wouldn 't use the va or navy doctor 's .
holder filed a three-page letter .	the judges orders a three-page letter to be filed .
@ lustig andrei , lustig , agreed .	@ lustig andrei , thank you , lustig .
this eclipses the old record of set in .	this breaks the daily record of set in .
zimmerman replied , " what are you doing here ? "	martin said , " why are you following me ? "
i don 't know how legitimate this is , but i heard he 's kind of suicidal .	so , i don 't know how legitimate this is but yeah .
council tax hasn 't council tax been frozen for most people ?	hasn 't council tax been frozen for most people ?
your schtick is getting stale .	your misogyny is getting messy .
is that how it works ?	nah , that 's not how it works .
breathe in , breathe out , move on .	buwhahahaha breathe in , breathe out , move on .
wait until they become more consistent and closer together .	wait for the contractions to get stronger and closer together .
obama is extreme and leftwing .	obama is part of the extreme leftwing .
@ frank apisa , what you want to call it is up to you .	@ cyracuz , what you want to call it is up to you .
jury nullification has nothing to do with the constitutionality of laws .	jury nullification means a law isn 't constitutional ?
what conviction where you talking about before ?	what conviction would that be ?
so i actually read the op and guess what i found out .	furthermore i found this : so i actually read the op and guess what i found out .
the government does not determine if you are married or not .	the government doesnt have to declare you married before you can be married .
democracy is a threat to liberty .	democracy has nothing to do with liberty .
hi pro and corn : how many threads do you plan on making ?	how many threads do you plan on making ?
tell me exactly which system isn 't working right now ?	so which system isn 't working for us ?
oh , and again asserts that marriage is a fundamental human right .	particularly after stating that marriage is a fundamental human right .
why are russians in damascus ?	russians in damascus !
yes , it 's about dilution .	er , that 's not how dilution works .
yeah , i don 't think this is that controversial either .	i don 't think what she 's saying is that controversial .
operation chaos is merely people voting .	chaos is merely people voting .
originally posted by jond doubtful .	originally posted by eleanor.ellis
classical gas we are all vessels filled with many wonders .	the theme song to cheers : we are all vessels filled with many wonders .
to repeat : they are not as sovereign as they were before .	they are not as sovereign as they were before .
morals have absolutely nothing to do with it !	and morals and honesty have everything to do with it .
i be having conversations will cornell west my dear brother .	i be having conversations will cornell west what the hell is this ?
there is no war in the middle east .	there is no " war " in the middle east .
he had no intention of apprehending him .	- i didnt say he planned on apprehending him .
we are all vessels filled with many wonders .	put a little love in your heart we are all vessels filled with many wonders .
you 're " a bunch of cells . "	i 'm " a bunch of cells . "
what is a girl douche ?	you are a girl douche .
jury nullification means a law isn 't constitutional ?	no . jury nullification does not mean that a law is unconstuitutional .
it 's definitely not what it used to be .	voted voted it 's definitely not what it used to be .
the onus is on the manufacturer of a product to convince consumers it is safe .	the manufacturer has to convince the government it 's safe .
i think you are missing the point with entrepreneurs .	again i think you are missing the point on the twain quote .
" cyclopes don 't exist " - fine .	" goblins don 't exist " - fine .
" in it was a mental illness , now what are they teaching you ? "	he stated that it was a mental illness in , how is that bigotry ?
landon and so this is christmas we are all vessels filled with many wonders .	play with fire we are all vessels filled with many wonders .
bush gets zero credit for the budget under him .	and , obama gets zero credit for the budget under him .
. sinful people do not get to heaven .	or sin is removed upon entry to heaven .
how long after the obliteration should the kid return to school ?	how long after the obliteration should it no longer bother the kid ?
holly holy we are all vessels filled with many wonders .	say what you will we are all vessels filled with many wonders .
what was the " answer " in chicago ?	what will be the response in california ?
the entire thing just makes no sense .	see that makes no sense .
who supposedly operated the homicidal gas chambers ?	refresh your memory : who supposedly operated the homicidal gas chambers ?
therefore , the explanation of the existence of the universe is god .	if the universe has an explanation of its existence , that explanation is god .
genetic predisposition to cancer resistance is superior genetics .	genetic predisposition to alzheimer is inferior genetics .
do you notice the nonsensical things you are saying ?	and to be fair , do you notice the nonsensical things you are saying ?
use of force in defense of person.-a	use of force by aggressor .
that 's what the data available shows .	that 's what the historical record shows .
joy to the world we are all vessels filled with many wonders .	the theme song to cheers : we are all vessels filled with many wonders .
i thought that was mostly just the dutch .	in fact , it 's just the dutch .
ive watched kids play .	i like watching kids play .
david @ omsigdavid , i think santorum 's more likely than gingrich .	@ sozobe , i think santorum 's more likely than gingrich .
they 're looking at each other !	why are they looking at each other like that ? ! ? !
are you driving one ?	are you driving a fucking volt ?
religion that does that i have a problem with .	irreligion that doesn 't do that i don 't have a problem with .
i think he 'd be better for american business interests overall .	would he be better for american society ?
not a constitutional issue .	again , this is not a constitutional issue .
you fools .. bought the cover-up .. hook ..	hi eots : you fools .. bought the cover-up .. hook ..
" what does pressing the number one do ? "	" pressing the number one does english . "
what conviction would that be ?	what conviction where you talking about before ?
originally posted by spikdboy not wishful thinking , rather realistic .	originally posted by objectivism not wishful thinking , rather realistic .
for the trillionth time , i 've never said rehabilitation doesn 't work .	the point you quote should say " i never said rehabilitation could never work . "
charlie rangel censured did anyone see the footage of this ?	did anyone see the footage of this ?
red october standing by .	red fox standing by .
that 's just not how legal briefs are written .	that just isn 't how legal reasoning works .
no , none of those factors account for the recent warming .	you don 't know if those factors account for the warming , or not .
stone notified captain lord .	he too notified captain lord .
the primary focus of systematic dialectics is syn chronic , not dia chronic .	thus , meta - system - atic dialectic is diachronico - synchronic dialectic .
are you driving one ?	are you driving a fucking volt ?
and that is happening in gop controlled states .	michigan is a gop controlled state .
in foxe basin was frozen .	foxe was mostly frozen .
@ frank apisa , frank , i observe and perceive .	@ cicerone imposter , frank , i observe and perceive .
government deciding what pregnancies need to be carried to term , that 's fine .	government spying on its own citizens , that 's fine .
put a little love in your heart we are all vessels filled with many wonders .	landon and so this is christmas we are all vessels filled with many wonders .
higher than per cent but not very high .	lower than per cent but not very low .
what isn 't how what was sold ?	it 's not how it was sold , gb .
god definately does not exist .	god probably does not exist .
breathe in , breathe out , move on .	buwhahahaha breathe in , breathe out , move on .
it is an excellent indicator of climate change .	i think we all agree on the nature of the change .
the great thing about living here is there 's space .	the bad thing is there 's space .
ah ha , ha , ha , ha , ha !	ha , ha , ha , ha , ha , ha !
i don 't understand how freedom of speech will be prohibited .	your freedom of speech will be no more prohibited than it is today .
the question needs to be asked .	it is a question that needs to be answered .
you purport to value life very heavily .	i purport to value human life very highly .
the infestation posts .	the mosquitoes posts .
i don 't want a president who ' cares ' .	don 't want a president that is compassionate .
do you have anything to make it less compelling or not ?	do you have anything to make it more compelling ?
for the trillionth time , i 've never said rehabilitation doesn 't work .	the point you quote should say " i never said rehabilitation could never work . "
classical gas we are all vessels filled with many wonders .	time of the season by the zombies we are all vessels filled with many wonders .
peeve so we agree that it came down essentially in freefall ?	do we agree that they came down essentially in freefall ?
pro-life people do not want a woman to be able to choose abortion for herself .	pro-choice people do not try to force an abortion on anyone .
so answer the question .	stop avoiding the question .
haiti is a shithole .	haiti has been a shithole .
i absolutely do believe there was an iceberg in those waters .	i don 't believe there was any iceberg at all anywhere near the titanic .
the face of the franchise : the worst part is that he 's not even a leafs fan !	the worst part is that he 's not even a leafs fan !
i agree completely i am hoping he is into a second term of office .	i am hoping he is into a second term of office .
jake with the assist .	voracek with the goal .
is it possible his home was affected and the school was not ?	sure , it is possible his home was affected , but not the school .
the people had awakened .	because the people had awakened .
umm the california was a cargo ship i dont care what the article says .	the california was a cargo ship .
umm , that pretty clearly states , " the statute is presumed constitutional . "	and until they decide that , " the statute is presumed constitutional . "
florida the ignorance is yours !	the ignorance is yours !
i 'm going to shout for justice for trayvon .	the people shouting for justice for trayvon are all hypocrites .
how do you know what 's right and wrong ?	how do you know which story is the right one ?
ha , ha , ha , ha , ha , ha !	ah ha , ha , ha , ha , ha !
and nugent was a complete fool to say what he said .	natalie was a complete fool to have insulted their fan base .
it is all bush 's fault .	obama is bush 's fault .
you should stop prefixing or suffixing everything with you hate jews .	i don 't prefix or suffix everything with " you hate jews . "
i missed the point where he said that black people were going to riot .	never , did i ever , did i say blacks were going to riot .
yet you didn 't have to declare it .	and you didn 't have to .
proverbs john the baptist was a nazarite from birth .	john the baptist was a nazarite from birth .
james : says faith without works is dead .	paul did not preach faith without works .
billion . everyone in the world at mexico 's current prosperity level .	everyone in the world at the current " prosperity " level of northwest africa .
and videos seismic data does not equal duration of collapse .	seismic data does not equal duration of collapse .
originally posted by lone fox you 've said that multiple times now .	originally posted by lone fox and it 's not all iranian related either .
you might not like obamas views , but he has them .	you might not like the positions he holds , but atleast he has them .
but do you actually believe there was an iceberg in those waters ?	i absolutely do believe there was an iceberg in those waters .
there is simply no winning for obama among conservatives .	this is rich coming from a conservative .
satan represents indulgence instead of abstinence !	. satan represents vengeance instead of turning the other cheek !
just so long as the tax on that sale is paid .	just so long as the tax is paid .
fix ? : islam itself is not political .	islam has always been political .
march is also the date for the uprising in china .	originally posted by vitchilo march is also the date for the uprising in china .
i hope everything is ok !	i hope everything is okay .
do you understand why it 's absurd to limit the question to us residents ?	do you understand why non-us residents are also relevant to the statistics ?
i have seen ufo over warsaw in the past .	respectfully submitted , steve i have seen ufo over warsaw in the past .
depending on which action furthers their loony-tunes agenda of the moment .	depending on which action furthers their lonny-tunes agenda .
do you further agree that i have made no claim ?	so that you will admit and verify that i have made no claim .
zimmerman says that he was sucker punched by his car .	his " friends " say that he was confronted by his car .
there is no " war " in the middle east .	there is no war in the middle east .
part of pro-life is the opposition to legalized abortion .	pro-life also refers to just " opposition to abortion " .
capital gains , top rate : percent .	- income , top rate : percent .
time of the season by the zombies we are all vessels filled with many wonders .	the theme song to cheers : we are all vessels filled with many wonders .
no , i show you are willfully ignorant .	lol , you are so ignorant .
we are all vessels filled with many wonders .	jingle bell rock by bobby helm we are all vessels filled with many wonders .
the problem isn 't who has money .	the problem is who doesn 't have money .
sadly ford did accept taxpayer money .	ford didn 't accept taxpayer money to save the company .
the muslims would say the same thing about the qur 'an .	the hindus would say the same thing about the bhagavad ghita .
your confusion doesn 't make me a liar .	then your confusion doesn 't make me a liar either .
when christians are extreme its just simply religion .	when muslims are extreme it 's terrorism .
some believe the ' right ' is most important .	some believe not slaughtering the unborn is most important .
evolution is not an opinion , not a belief .	atomic theory is not an opinion , not a belief .
i am not the one claiming the right to decide over another woman 's body .	you want others to decide over a woman body .
where in the world is ron paul ?	where in the world is the media ? ?
you have no remains of a missile at the pentagon .	you have no remains of an a- at the pentagon .
the point you quote should say " i never said rehabilitation could never work . "	for the trillionth time , i 've never said rehabilitation doesn 't work .
billion . everyone in the world at mexico 's current prosperity level .	everyone in the world at the current " prosperity " level of northwest africa .
my hair is pretty thing tho : / quote : ditto .	my hair is pretty thing tho : / woops !
it wouldn 't stop joke marriages .	and i don 't fight for marriage .
you seem to think that poor people are not responsible for their actions .	people are responsible for their actions .
why did that transaction take place .	did the transaction take place ?
it 's about the baggage attached .	it 's not the same thing .
we are all vessels filled with many wonders .	put a little love in your heart we are all vessels filled with many wonders .
the problem isn 't who has money .	the problem is who doesn 't have money .
what makes you think the owl didn 't participate ?	it doesn 't say that it didn 't participate .
lol looking forward to seeing your built-in 's !	look forward to seeing it !
originally posted by jacko !	originally posted by izzy !
thanks candy for starting the thread .	candy - thanks for starting us off today .
except that it wasn 't .	except that they couldn 't .
if i owe you , dollars , i have a problem .	if i owe you a trillion dollars , you have a problem .
if evidence is not provided to support a position ; then it should be rejected .	if a position is unverifiable ; then it should be rejected .
everyone else at the current prosperity level of mexico .	everyone in the world at the current " prosperity " level of northwest africa .
bush gets zero credit for the budget under him .	and , obama gets zero credit for the budget under him .
lol don 't you have to take a test to drive a vehicle in the us ?	is there a test to own a firearm in the us ?
we both thought the movie was good and we didn 't find it confusing in any way .	i thought it was good , and i didn 't find it confusing .
if god does not exist can anything be morally wrong ?	i ask again if god does not exist can anything be morally wrong ?
a law is constitutional if it does not conflict with the constitution .	to be unconsititutional means to violate the constitution .
originally posted by muslim girl ooops sorry !	originally posted by muslim girl its not a complete impossibility .
this is not your country .	this is our country .
originally posted by zaf i suppose the water in the middle makes a difference .	originally posted by zaf in the long term , yes .
cone threw an game .	addie joss cone threw an game .
edited by lashl : edited to properly mask profanity .	edited by lashl : edited to properly mask profanity in quoted post .
the jury is not told about juror nullification .	the quote you provide has nothing to do with jury nullification .
runs victim down got any proof ?	paranoid got any proof ?
you don 't use the search button much , do you ?	you don 't use the search button at all , do you ?
i don 't think paul has a shot .	paul doesn 't have a shot .
time of the season by the zombies we are all vessels filled with many wonders .	joy to the world we are all vessels filled with many wonders .
do you notice the nonsensical things you are saying ?	and to be fair , do you notice the nonsensical things you are saying ?
what if they messed up a study ?	what if they had a personal bias ?
specifically a baptist .	specifically gnostic .
and a large part of the east coast .	and parts of the west coast .
why are you talking about women within the hebrew tribes ?	we were talking about women as war bounty were we not ?
last night japanese forces attacked hong kong .	last night japanese forces attacked the philippine islands .
. what is your definition of " life force " ?	what is your definition of " soul " ?
that is not direct responsibilty to the constituents .	aye but they are responsible to their constituents .
the ideology was built around violent expansion , so yes - violent expansion .	the ideology was built around violent expansion and race superiority .
could this have been an enema ?	@ ossobuco , could this have been an enema ?
my final word : ignoring has the effect of normalizing .	taking advantage has the effect of reinforcing .
