global online # education is a key to democratizing access to learning and overcoming societal ills such as poverty -	op-ed columnist : revolution hits the universities
hollywood accepts chinese censorship ( will movies get any better ? )	in hollywood movies for china , bureaucrats want a say
# bloomberg : assault weapon ban tough sell pub. enemies 1 and 2 according to minor mayor : big gulps and # guns . # ocra	bloomberg : assault weapons ban is tough sell
car bomb detonates outside # afghan intelligence agency ; casualty toll unclear .	powerful car bomb explodes outside afghan intelligence agency
what 's in feinstein 's gun bill - # tgdn # pjnet	what 's in feinstein 's bill ?
linda greenhouse : roe v. wade was abt drs facing prosecution for acting in what they saw as patients ' best interests	opinionator : misconceptions about roe v. wade
special measures for beijing polution :	smog cloud blankets beijing
synthax _ terror 2 : : " american taliban " john walker lindh wins case over muslim group prayer in prison	'american taliban ' wins right to group prayer
the questions oprah should 've asked lance amstrong	hard questions for lance armstrong
cc " : at least 90 killed in brazil nightclub fire "	hundreds killed in brazil nightclub fire
not a tear here : red brigades jagoff dies , year older than me , fuck him :	prospero gallinari , a terrorist , is dead at 62
so many places to go ...	the 46 places to go in 2013
as # california bounces back , governor calls for lofty goals	with california rebounding , governor pushes big projects
nytimes : # leishmaniasis : a # genetic link found in far-flung victims of a lethal form of a parasitic disease	global update : a genetic link found for victims of lethal form of leishmaniasis
jesus ... at least 245 dead as fire sweeps through nightclub in brazil .	scores dead as fire sweeps through nightclub in brazil
so the company mad , isn 't this what most companies are doing ?	u.s. man outsources job to china , surfs cat videos
taking aim # stopgunviolence # congress # nra	obama , gun policy and the n.r.a .
# nra releases target shooting app , hmm wait a sec ..	nra draws heat for shooting game
broken limbs , torn lives in northern # mali # africa # conflict # humanrights	broken limbs , torn lives in mali
slams guest over ar-15s	piers , guest clash over ar-15s
a truckload of flaming brown cheese closed a road tunnel in arctic norway for the last six days .	world briefing | europe : norway : cheese fire shuts tunnel
sex abuse common , but so is our inability to face road range of behaviors common to humans a pedophile in plain sight	opinion : at poly prep , a pedophile in plain sight
death toll climbs to 220 in # brazil nightclub fire , official says .	hundreds killed in brazil nightclub fire
( i love him ! ! ! ! ) 10 reasons we can 't get enough gosling -	why we can 't get enough gosling ( duh ! )
u.s. withdrawal is ' tough love ' for afghans	u.s. ' tough love ' for afghan troops
nytimes : andrew revkin on next steps for china in cleaning up pollution .	charting a post-pollution path for cities - from london , 1952 , through beijing , 2013
justice clarence thomas breaks his silencetell the justice that courtesy will not protect citizens rights.get with it !	justice thomas breaks his silence in court
nato : missile battery opens on syrian border this could set forth an unwanted chain of events here .	nato : patriot missile battery operational on syrian border
what 's wrong with the boeing dreamliner ? " . airlines must be so happy !	what 's wrong with the dreamliner ?
hopefully not together " : richard pryor & dick cheney focus of showtime documentaries "	richard pryor and dick cheney focus of showtime documentaries
we will pass a milestone this year : the majority of the fish we eat will be farm-raised rather than wild	a milestone looms for farm-raised fish
design , design , design . ? we ? re on the tail end of technology being special , ? says john maeda .	disruptions : disruptions : design is driving technology forward
interesting article on the cnn homepage . " mickleson has a point on taxes . "	mickelson has a point on taxes
pictures of the day : pakistan , syria , indonesia , germany , phillipines and mali .	pictures of the day : pakistan and elsewhere
how # vine video may change twitter # in	6 ways vine 's six seconds may change twitter
+ 1 mt ? " i loathe writing with .. a kind of phobia .. only a sort of perverse masochism keeps me at it " styron	? selected letters of william styron ?
sport : mt lance armstrong confesses to doping . next step ? testifying against the higher-ups in cycling .	armstrong admits doping , and says he will testify against cycling officials
bloomberg chips in a billion	bloomberg gives $ 1.1b to university
u.s. government-supported rescue mission of french hostage in somalia failed .	u.s. supported france 's failed hostage rescue in somalia
nytimes : is delhi so different from steubenville , usa ?	op-ed columnist : is delhi so different from steubenville ?
cardinal mahony , abuser of liturgies and shielder of child abusers . so sad and frustrating .	mahony shielded abusive priests , documents show
" tennis : djokovic claims aussie triumph zmerchnews dot com "	djokovic : 3 aussie wins in a row
man crapping killed in fall between subway cars	train kills man in 125th street subway station
# us details help in failed # hostage rescue . # somalia # france	u.s. supported france 's failed hostage rescue in somalia
microsoft 's windows 8 sales are ok , not great cnnmoney	microsoft 's windows 8 sales are big -- just not big enough
internet activist # aaronswartz , creator of # rss , is dead at 26- suicide . was the pressure of pending lawsuits too much ?	aaron swartz , internet activist , dies at 26
the truth about publicity ... bad publicity does exist . # pr # media	maybe there is such a thing as bad publicity
# revolution hits the # universities by # distance # education # sustainability	op-ed columnist : revolution hits the universities
vicki huddleston : why we must help # save # mali	op-ed contributor : why we must help save mali
this is a weird article . " ray kurzweil says we ’ re going to live forever "	talk : ray kurzweil says we ? re going to live forever
daannngg ! ? : lance armstrong tells oprah he couldn ? t have won 7 tour de france titles without doping ?	armstrong stripped of olympic medal
apple makes a $ 13.1 billion profit , sells 28 % more iphones and 48 % more ipads . stock dips 11 %	apple ? s profits are flat , and stock drops
when does life begin ? catholic hospital argues that an embryo is not a person .	catholic hospital 's lawyers argue fetus not a person
two years after the egyptian revolution ... u.s gets it wrong on egypt again -	opinion : u.s gets it wrong on egypt , again
after armstrong admits doping 2 oprah years 2 late , he now says he will testify against alleged doping officials	armstrong admits doping , and says he will testify against cycling officials
wait , bribing kids is bad ? # notmomoftheyearafterall	this life : modifying a child ? s behavior without resorting to bribes ? this life
# disney ' s new # videogame , via nytimes : video game combines the worlds of disney	media decoder blog : new video game features disney and pixar mash-ups
in the gowanus canal , a dolphin	dolphin swimming in gowanus canal
senator schumer says he ? s satisfied with chuck hagel on the mideast . his endorsement should settle that issue .	schumer says he ? s satisfied with hagel on mideast
producer of popular gun-related videos shot . every gun death is a tragedy .	producer of popular gun-related videos found fatally shot
interesting and sensible	opinionator : back when i was packing
sign of inaccessible , culturally incompetent mainstream care ? as ? bodega clinicas ? fill void , health officials are torn	? bodega clinicas ? draw interest of health officials
rome 's colorful colosseum	rome 's colosseum gives up secrets
" : samsung profit at record $ 6.6 billion "	samsung profit soars to $ 6.6b record
spanish police seize items intended for iran . qu ? mal rollo ...	spanish police say seized items intended for iran nuclear program
this is a pretty amazing read . # howstuffworks nytimes : coins , bills and the national debt	economix blog : bruce bartlett : accounting for a $ 1 trillion platinum coin
fitness center in a # hotel room	urban athlete : a hotel room workout from nicole glor
i 'm surprised by the lack of coverage of the n ireland riots .	police deploy water cannon at northern ireland riot
saudis defend # srilankan maid 's # execution	saudis defend maid 's beheading
the worst kind of poor flying judgement . stunt plane barely missing two people prompts faa probe .	video of stunt plane barely missing two people prompts faa probe
on hillary clinton 's fp approach	iht rendezvous : the clinton doctrine of american foreign policy
an insider returns to politics in italy # memofromrome # politics	berlusconi stirs up elections in italy
sign of the # apocalypse : voice of charlie brown arrested , charged . ?	good grief ! charlie brown actor charged
a really nicely written story : in the subways , a voice to stir the soul	in the subways , geechee dan ? s voice stirs the soul
ces keynote : young people today are ' born # mobile ' # hitech	ces : young people are ' born mobile'
what prevents people from being able to die at home is not their medical needs , but the needs of their # caregiver # hpm	the new old age blog : what you need to bring your loved one home to die
u.s. warplanes enter somalia airspace mr. potus ; write another letter & tell french we 're not in the mood for their mess .	u.s. warplanes enter somali airspace
climate change at cnn : next step : obama 's state of the union speech on february 12 ....	climate change activists to obama : steer clear of congress
rss and reddit co-developper aaron swartz commits suicide	online activist aaron swartz commits suicide
charlie brown voice actor charged	good grief ! charlie brown actor charged
njff is showing this film on jan 26 at rutgers university :	our generation : ? set for life ? documents crisis among baby boomers
dreamliner having fitful rollout . how tough is this for boeing ?	deepening crisis for the dreamliner
what we don ’ t know is killing us the gun industry can 't handle the truth .	editorial : what we don ? t know is killing us
india ink : woman raped by seven men in punjab , police say : police said sunday that a 29-year-old woman had been ...	india ink : woman raped by seven men in punjab , india , police say
# photos : # kimjongun and his army forces	photos : kim jong un and his military
indonesian official : rape victims enjoy it oh hell no they don 't	would-be judge suggests women enjoy rape
so wait , you think i want to search # facebook , and use bing as the back up ? ha .	bits blog : facebook unveils a new search tool
icymi , facebook unveiled a new search tool today : " graph searchl "	bits blog : facebook unveils a new search tool
" humanitarian emergency . " declared by aid groups in syria "	'humanitarian emergency ' in syria
president ? if she wants it	president hillary clinton ? if she wants it
they deserve such unkind words .	kenyan rangers hunt poachers who killed 11 elephants for ivory
a great piece in the nyt mag on story , lit , and media .	riff : once upon a time , there was a person who said , ? once upon a time ?
review : facebook 's graph search not v. useful - cnn " only two of my 526 friends like cats " ... say no more	review : facebook 's graph search is not very useful
ukraine signs shale gas drilling deal with # shell at # davos # energy # marketentry	ukraine signs drilling deal with shell for shale gas
by the numbers : women in the u.s. military nah not good idea	by numbers : women in u.s. military
try something new on your next vacation .	exotic culinary tours around the world
" : britney spears calls off engagement " loool cnn reports this ? where is this world going ?	britney spears , jason trawick call off engagement
pooping man killed in fall between subway cars	train kills man in 125th street subway station
thank goodness . ? : man charged with murder in philadelphia doctor 's death . ?	man charged with murder in doctor 's death , source says
teen murdered in west bank by israeli military occupation force , activists say -	teen shot in west bank by israeli military , activists say
live to eat or eat to live ? i take the former .	big city : new generation confronts unaffordable luxury of food
boosting your # flu shot response with # exercise	exercise can boost flu shot 's potency
smartphones are lifes remote control -	smartphones can now run consumers ? lives
er diab ... " : at least 245 killed in brazil nightclub fire "	hundreds killed in brazil nightclub fire
2013 oscar nominations : who got	2013 oscar nods : who got snubbed ?
nyt reports on my intvu with ehud barak , links to daily beast # wef # israel # iran # nukes # war	defense official hints that israel is stepping back from plans to unilaterally attack iran
convicted in thailand of * implying * an insult to the king . ? there was no mention of the king ? s name in the speech . ?	in thailand , a broader definition of insulting royalty
" escape from la crosse " the preppers next door	the doomsday preppers of new york
can oprah save lance armstrong ? she 's not convinced # doprah	can even oprah save lance armstrong ?
notre dame linebacker victim of a catfish type hoax ?	notre dame linebacker says he is victim of hoax
morning athletic inspiration ( let everyone compete ! ) : forging path to starting line for younger disabled athletes # nyt	disabled athletes suit up , raising questions of logistics and fairness
michael r. bloomberg credits # johnshopkinsuniversity for turning him into a leader	at $ 1.1 billion , bloomberg is top university donor in u.s .
this is ludicrous . sheriff : i won 't enforce obama 's gun laws . really ?	sheriff won 't enforce ' unconstitutional ' gun laws
man outsources own job to china	u.s. man outsources job to china , surfs cat videos
morsi ? s slurs against jews in 2010 uncovered	morsi ? s slurs against jews stir concern
thins just don 't add up just when north korea successfully lunched a rocket now america allows this . or am i ...	how america 's top general came to endorse women in combat
you are an # inspiration ! # keepfighting	the front lines in fight for women
study : college-educated weathered downturn best :	study shows college degree ? s value during economic downturn
sadness . " : dolphin stuck in polluted nyc canal dies . ”	dolphin stuck in new york canal dies
" errors may have exposed veterans to viruses " uh oh ...	insulin injection errors may have exposed veterans to viruses
today i learned " currently , there is no federal law that defines gun trafficking as a crime . " i am at a loss for words .	senator unveils bill to limit semiautomatic arms
president obama turning to ex-prosecutor mary jo white to be securities and exchange commission ( s.e.c. ) boss	mary jo white to be named new s.e.c. boss
wow . a brief but eye-opening piece in the : a pedophile in plain sight	opinion : at poly prep , a pedophile in plain sight
good read ... why the net grieves aaron swartz -	why world grieves aaron swartz
finally armstrong admits doping , and says he will testify	armstrong admits doping , and says he will testify against cycling officials
great informative article that shows pepsico 's cooperation with resolving this health issue and placing consumers first	gatorade listens to a teen and changes its formula
how the us has changed in my lifetime :	from reagan to obama , how we have changed as a nation
the new york times : chinese firm buys u.s. solar start-up	chinese firm buys an american solar technology start-up
in france , protesters rally against allowing same-sex marriage	french rally : no to same-sex marriage
follow the dinero : cuomo raises $ 22.5 million for re-election bid	cuomo raises nearly $ 22.5 million for re-election campaign
china is investing in # education - # highered # edpolicy	next made-in-china boom : college graduates
can livestrong survive lance armstrong doping admission ?	livestrong has life after lance
build a fence around your good health ! your top flu questions answered .	your top 10 flu questions answered
johnson & johnson aware of 40 % failure in hip implant # hipimplant	maker aware of 40 % failure in hip implant
'is there a worse way to live ? ' ( cc : ) # jidf	'is there a worse way to live than this ? '
gun violence is absolute a # publichealth issue . good work , on your gun reform for a generation # itsastart	editorial : president obama ? s plan for gun reform
az gov jan brewer changes her mind and will expand medicaid : # medicaid	national briefing | southwest : arizona : governor relents on medicaid
worth reading for the column excerpts : pauline phillips , dear abby , dies at 94	pauline phillips , flinty adviser to millions as dear abby , dies at 94
# myanmar s fight with armed # rebels edges toward china # burma # kachin	myanmar fighting edges toward china
truly a sad day . at least 90 killed in brazil nightclub fire	hundreds killed in brazil nightclub fire
us inadvertently trained rebels : french strikes in mali supplant caution of u.s .	french jets strike deep inside islamist-held mali
calorie bomb on the menu will make eaters feel guilt after finish those meals	9 calorie bombs at restaurants
facebook was the most popular mobile app in the united states in 2012	facebook 's mobile app takes top spot
an alarm in the offing on # climatechange # extremeweather # globalwarming # eco	an alarm in the offing on climate change
syria : deadly airstrikes in damascus	syria launches deadly airstrikes in damascus suburbs
two of our favorite partners , and , have teamed to bring more music to your commute .	ford announces in-car voice commands for amazon 's cloud music
amazing , you can play violent shooting games & nobody says anything but the nra draws heat over new target-shooting game	nra draws heat for shooting game
worth watching . " set for life " documenting a generation ? s fall . # work # unemployment # babyboomer	our generation : ? set for life ? documents crisis among baby boomers
dreamliner fix : ' it 's not easy ' - this a big mess that is not easy .	787 dreamliner fix : ' it 's not easy'
nyt editorial : what we don ’ t know is killing us # research # guns # violence	editorial : what we don ? t know is killing us
think so ? they don 't think so !	president hillary clinton ? if she wants it
pulitzer-winning poet tracy k. smith 's sunday routine :	poetry , puppets and playgrounds
position " eliminated " . hmm . i read " exterminated " . times executive is leaving	times communications executive is leaving
mr. drummond , yep ... showing my age : conrad bain , father on ? diff ? rent strokes ? , dies at 89	conrad bain , actor on ? diff ? rent strokes , ? dies at 89
saudi arabia defends maid 's execution	saudis defend maid 's beheading
" facebook has a lot of data , but it ? s very noisy data . "	fortunes of facebook may hinge on searches
cnn recent nightclub tragedies : on saturday , a massive fire at the kiss nightclub in southern brazil killed at l ...	deadly blazes : nightclub tragedies in recent history
north korea sendin them threats again	north korea issues blunt new threat to united states
we 're all human , no more death please ! another tibetan sets himself on fire , dies to protest chinese rule	tibetan sets himself on fire to protest chinese rule
coca-cola joining the fight on obesity	coca-cola weighs in on obesity fight
prayers for burt reynolds	burt reynolds ' feeling better ' but still in icu , rep says
'taliban ' is plural , but that is apparently too esoteric for cnn or any other journalists : .	'american taliban ' wins right to group prayer
saudi activists say they won 't be silenced ~ ~ i hope they find a way to get their rights peacefully !	saudi activists say kingdom trying to silence them
when doctors don 't listen what can you do ?	what to do when doctors don 't listen
jodie foster would care more about syria launching deadly airstrikes in damascus suburbs	syria launches deadly airstrikes in damascus suburbs
bending the steakhouse rules # food # eatingout	restaurant review : arlington club on the upper east side
excellent step with tricky legal issues.new york lawmakers reach deal on new gun curbs # law # cdnpoli	new york legislators hope for speedy vote on new gun laws
'anonymous ' threatens justice dept . ' anonymous ' threatens justice dept	hacktivist group threatens justice department
at least 245 killed in brazil nightclub fire , such a shame	hundreds killed in brazil nightclub fire
internet addiction of the day : ' what happens when you cast lindsay lohan in your movie'	here is what happens when you cast lindsay lohan in your movie
great piece by in nyt showing china too has what mckinsey sees as a global education-to-work problem :	chinese graduates say no thanks to factory jobs
on the virtues of procrastination : this was supposed to be my column for new year ? s day	findings : positive procrastination , not an oxymoron
france : we 're not the pacifists you think we are - mali	why france is not pacifist nation
the bizarre world of online relationships : image of manti te 'o becomes a puzzle as theories swirl	image of manti te ? o becomes puzzle as theories swirl
washington 's economic boom , financed by you real life " hunger games "	washington ? s economic boom , financed by you
finally confirmed - chapped lips are the first sign you ? ve got mad cow disease .	opinion : hypochondria : an inside look
swatch plays a big hand on $ 1b harry winston acqusition get it , big hand ... # iexplainmyjokes	swatch to buy watch and jewelry business of harry winston for $ 750 million
states get extension on # healthexchange timetable : : states get extra time to set up exchanges # aca # hcr	states will be given extra time to set up health insurance exchanges
" live by the sword ... " sad and ironic . producer of popular gun-related videos shot	producer of popular gun-related videos found fatally shot
kobe bryant , wife to call off divorce yaayy ! lol .	kobe bryant and wife call off divorce
excellent ! ? : # obama accelerating troops withdrawal from # afghanistan , several months ahead of schedule : ?	obama , karzai to speed military transition
obit : vincent sombrotto , leader of 1970 strike that shut post offices across country ' til nixon sent the national guard	vincent sombrotto , who led postal strike , dies at 89
so heartbreaking “ : at least 90 killed in brazilian nightclub fire , officials say . ”	hundreds killed in brazil nightclub fire
more reason to review a more progressive pro-domestic tax structure " america 's productivity climbs , but wages stagnate "	news analysis : america ? s productivity climbs , but wages stagnate
this is interesting : " what we don ’ t know is killing us " .	editorial : what we don ? t know is killing us
when i first saw this sing guy on the subway , i thought he needed an article . and nyt has delivered !	in the subways , geechee dan ? s voice stirs the soul
germany to move 674 tons of gold from downtown manhattan to frankfurt ..	germany to repatriate some of its gold reserves
this just warmed my heart : ada bryant and robert haire	ada bryant , robert haire ? weddings
# new york city ties # doctors ? # income to # quality of # care	new york city hospitals to tie doctors ? performance pay to quality measures
ny times : dot earth blog : is ' wild west ' era for fracking coming to an end ?	is ' wild west ' era for gas drilling coming to an end ?
children handcuffed 4 violating dress code ! # ms fills # school2prison pipeline reports grantee .	report criticizes school discipline measures used in mississippi
congratulations to # fruitvale and # bloodbrother ! sounds like # sundance had some powerful films this year .	the carpetbagger : ' fruitvale , ' drama with little advance buzz , wins at sundance
sleep , perchance to dream and our memories not unseem mt : brain ageing & sleep-related memory decline ”	brain aging linked to sleep-related memory decline
my pbk membership , finally explained . parents ? financial support may not help college grades :	parents ? financial support linked to college grades
tennis : sharapova takes on boys	sharapova takes on australian boys
fda may find that poop is a drug . nytimes : when pills fail , this , er , option provides a cure	disgusting , maybe , but treatment works , study finds
only great things can happen at the cheese monger : in the dairy case , ripe prose	creative cheesemongers pen clever descriptions
peter likes : dealbook : dell shares rise on news company may go private	dealbook : dell shares surge after report of possible buyout
kaepernick backs harbaugh 's gamble with playoff win	kaepernick responds to harbaugh ? s gamble with resounding performance
republican governors open new front in # tax debate offering bold # solutions !	the caucus : republican governors open new front in tax debate
for the record , i chopped my hair into " the karlie " before karlie ; )	the ? karlie ? is turning heads
familiarize yourselves : # northkorea	for the u.n. and north korea : game on
new mutations discovered in # melanoma useful in decoding how it develops . # cancer	new mutations discovered in melanomas
not so good news .... nytimes : german economy shrank in fourth quarter	german economy probably shrank in fourth quarter
u.n. agencies : stop the suffering in syria again . powerless .	u.n. : stop the suffering in syria
conservative writer nicholas kristof : guns are " an instrument not of protection but of escalation . "	op-ed columnist : lessons from guns and a goose
nytimes : robot makers say automation will create new and better jobs and not only delete jobs	robot makers spread global gospel of automation
new low for water levels in the great lakes # drought	water brings new lows on great lakes
britain to auction 250 mhz for high speed mobile -	britain set to join high-speed mobile party
nytimes : apps and other digital tools lend a hand ...	tool kit : apps and other digital tools lend a hand to new mothers
compared dna from 6,000 visceral leishmaniasis blood samples from india & brazil shows similar variations .	global update : a genetic link found for victims of lethal form of leishmaniasis
so , can we just pass the era now ? pentagon is set to lift combat ban for women	pentagon lifting ban on women in combat
germany to move 674 tons of gold # germany # europe # usa	germany to repatriate some of its gold reserves
“ : secret service dog falls to its death ” 😢 🐶	secret service dog falls to its death while on vp detail
* * * * * nytimes : security firm discovers cyber-spy campaign * * * * *	bits blog : security firm discovers global spy campaign
# obama plan : tougher checks , no assault weapons - - from # guncontrol	gop balks at gun control proposals
ken salazar leaving to spend more time with his bolo ties .	interior 's ken salazar stepping down
nike unveils rory mcilroy as tiger 's heir apparent . $ 200 mil deal ? ! ? makes no business sense to me .	nike unveils rory : tiger 's heir apparent
should babies be allowed to ' cry it out ' ? # attachment # parenting	should babies just ' cry it out ' ?
look of the moment : # taylorswift	t magazine : look of the moment | taylor swift
the plight of the atlanta falcons	nfl : can falcons turn it around ?
new york state has gun control deal , with focus on mental ills	new york legislators hope for speedy vote on new gun laws
tribal lessons - ' the world until yesterday'	? the world until yesterday , ? by jared diamond
so . odd . ? : in his own words : manti te 'o on his girlfriend , and her death - now revealed to be a hoax : ?	in his own words : manti te 'o on girlfriend 's death
j & j was aware of 40 % failure rate in depuy hip implants .	maker aware of 40 % failure in hip implant
following # colorado # marijuana legal decisions closely . maybe some lessons for ca dispensaries mess	op-ed columnist : colorado ? s marijuana muddle
ny times - a sprint that is littered with pitfalls	slap shot : n.h.l. ? s sprint of a season includes pitfalls
returning zing to dutch cooking ? let ? s go dutch ? ? # gartine	putting spice into dutch cooking
obama must prove himself on palestine : nytimes : netanyahu issues veiled barb in response to criticism from obama	netanyahu issues veiled response to criticism from obama
america , the saudi arabia of tomorrow - good or bad ?	america , saudi arabia of tomorrow
it hurts my stomach .	9 calorie bombs at restaurants
do you need a " stop day "	the importance of a ' stop day'
what happened in australia ... i went after guns . obama can , too .	op-ed contributor : australia banned assault weapons . america can , too .
will president obama 's gun proposals work ? recalling pain , mayors urge bills ? passage	recalling pain of guns ? toll , mayors urge bills ? passage
nyt books - books of the times : ? the river swimmer , ? a pair of novellas by jim harrison : ? the river swimmer , ? ji ...	books of the times : ? the river swimmer , ? two novellas by jim harrison
baby boomers getting tech savvy :	grandparents : the new techies ?
v kerry says # iran must come clean on # nuclear program	kerry confirmation hearing
woah . fox news did not renew sarah palin 's contract , which just expired .	fox news and sarah palin part ways
awe - one of the original " bloggers " passes away . pauline phillips , adviser to millions as dear abby , dies at 94	pauline phillips , flinty adviser to millions as dear abby , dies at 94
don 't get any ideas , . u.s. programmer outsources own job to china , surfs cat videos -	u.s. man outsources job to china , surfs cat videos
filmmaker jason da silva on the challenges of navigating ny with # ms : the long wait ? # sundance	op-docs : ? the long wait ?
this thing reads like one of those pre-written ' death ' articles . creepy .	burt reynolds in intensive care in florida hospital after flu , rep says
unfairrt : readers sue lance armstrong for book refund after doping admission : what do you think ?	readers sue armstrong for book refund
200 dead in night club fire	hundreds killed in brazil nightclub fire
nyt- pentagon lifts ban on women serving in combat roles	pentagon lifting ban on women in combat
" an earlier version of this review misidentified the torso that was featured when picnic opened on broadway ... "	theater review : ? picnic ? at american airlines theater
here 's to two more years of reince penis jokes .	priebus re-elected to lead republican national committee
new york passes gun control bill interesting , i like that they actually focused on mental health .	new york to pass first gun control bill since newtown shooting
miss montana has a great story to tell . # autism	miss montana on her autism
cgg - 30 die when bus plunges off cliff in nepal -	30 killed as bus plunges off cliff in nepal
a surprisingly refreshing view from old johnny howard . i went after guns . obama can , too .	op-ed contributor : australia banned assault weapons . america can , too .
" : in today ? s gun challenge editorial , obama puts politics aside and takes action on gun reform . "	editorial : president obama ? s plan for gun reform
in n.a.a.c.p. , industry gets ally against soda ban i 'm not one of them !	in court , n.a.a.c.p. adds voice against bloomberg ? s soda ban
and they never wondr why ! ! u.s gets it wrong on egypt again -	opinion : u.s gets it wrong on egypt , again
hurricane-flooded cars ruined by sandy lure unwitting buyers	hurricane-flooded cars lure unwitting buyers
in oz we love to scoff at us politics , gun laws etc . worth remembering us population debate years ahead of ours .	obama will seek citizenship path in one fast push
paging orval faubus : " oregon sheriff : ' unconstitutional ' gun control laws won 't be enforced " # guncontrol # newtown	sheriff won 't enforce ' unconstitutional ' gun laws
golden globes : how did tina fey and amy poehler do as hosts ?	golden globes kick off hollywood award season
in # turkey , mourners protest killings of # kurds	mourners in turkey protest killings of kurdish activists
chim : a vivid retrospective of post war europe # photography	chim : a vivid retrospective of europe
isn ? t it sad , that events like the massacre in conneticut have to happen for us to notice it # challenges	an added mission for arizona sheriff ? s immigration posse : school patrols
video : rome 's colorful collosseum :	rome 's colosseum gives up secrets
what the what ? ! ? : voice of charlie brown arrested , charged . ?	good grief ! charlie brown actor charged
here we go again .. a man says he 's ' certain ' he knows where hoffa is buried .	man convicted in mob crimes says he 's ' certain ' where hoffa is buried
man held after subway attack in philadelphia	man held after woman thrown onto subway tracks in philadelphia
even thought i 've downloaded # google maps for # iphone , i 'm still using # apple 's built in maps . they 're easier to use .	google gains from creating apps for the opposition
buried memories talks on a never before told true story of survival , memory and recovery .	" buried memories " of katie beers
the gulf 's ' green ' buildings # amman # cnn	coolest green buildings in the gulf
nytimes : n.r.a. attacks obama & daughters in video \ repugnant .	n.r.a. attacks obama in video
awful . " : more than 800 nyc rape cases to be reviewed for forensic mistakes "	more than 800 nyc rape cases reviewed for mistakes
here is my question , is lance being punished for cheating or for cheating better ?	public lashes out at armstrong
the reason kindles exist : the onion 's tossing out an e-book biography of biden	artsbeat : biden getting an autobiography from the onion ( whether he wants it or not )
info miami ’ s design district looks for an upgrade : a proposed $ 312 million renovation is expected to transform t ...	miami ? s design district looks for an upgrade
broken limbs , torn lives in northern # mali - # islamism # sharia	broken limbs , torn lives in mali
journalists , take a hint from andrew sullivan -	journalists , learn from blogger sullivan
this sweet love story made me weepy . no , really :	the race grows sweeter near its final lap
north korea beats war drums ...	n. korea makes new threats against u.s .
russian influence on rise in # israel	rise of russians in israel
life under islamist militants - broken limbs , torn lives in northern mali	broken limbs , torn lives in mali
good grief indeed , charlie brown gets arrested	good grief ! charlie brown actor charged
“ : “ : death toll climbs to 220 in brazil nightclub fire , official says . ” incredibly sad ” horrifying	hundreds killed in brazil nightclub fire
sad but brings back memories of ink-stained hands reading her column . what a life . nytimes : dear abby dies at 94	pauline phillips , flinty adviser to millions as dear abby , dies at 94
in desert outposts , border agents keep watch # elpaso # elchuco # lafrontera # mexico	at remote outposts , border agents sift for clues
the closest i 'll every get to hollywood : # greenfashion on the red carpet	iht rendezvous : green fashion on the red carpet
again : nytimes : 787 jet leaks fuel during safety test	japan airlines says 787 jet leaked fuel during safety test
some daily on daily crime right here . mt : on filib. reform ? unintelligible :	bipartisan filibuster deal is taking shape in senate
north korea ? s missile movements worry u.s. thom shanker and david e. sanger	movement of missiles by north korea worries u.s .
we are excited to see what happens ! ! ? south park ? creators start " important studios " # southpark	? south park ? creators to start company , important studios
cnn : helicopter crash rains debris on london street	helicopter crashes in london rush hour
online prodigy aaron swartz commits suicide god why ?	online activist aaron swartz commits suicide
is studio 54 like the ' 60s- if u can remember it , u weren 't really there ? selling some old sparkle fr studio 54 :	studio 54 memorabilia to be sold at auction
the climate is changing , not in the distant future , but now :	an alarm in the offing on climate change
extreme weather : expect the unexpected	extreme weather grows in frequency and intensity around world
ada bryant and robert haire you go girl ! !	ada bryant , robert haire ? weddings
nyt on aaron swartz : a data crusader , a defendant and now , a cause	aaron swartz , a data crusader and now , a cause
ignore the headline : more than 220 ... click on the link for updated via cnn . we 're seeing the numbers climb higher ...	hundreds killed in brazil nightclub fire
i 'm regretful that it has to come to this for some .	tibetan sets himself on fire to protest chinese rule
scaryyyyy ... questioning greek growth	world : green questions about greek growth
tragic news : a data crusader , a defendant and now , a cause	aaron swartz , a data crusader and now , a cause
you better believe in climate change , it 's real ! @ federal report sees big u.s. impacts from global warming	dot earth blog : draft federal report sees big u.s. impacts from global warming
: popular gun nut * shot dead in own home , nra thinks he needed more guns	producer of popular gun-related videos found fatally shot
this is so sad “ : 245 people killed in brazil nightclub fire , police tell state news agency . ”	hundreds killed in brazil nightclub fire
former australian pm says " i went after guns . obama can , too . "	op-ed contributor : australia banned assault weapons . america can , too .
nytimes : diderot , an american exemplar ? bien sûr ! a free thinker	op-ed contributor : diderot , an american exemplar ? bien s ? r
good grief ! charlie brown voice actor charged - # law # legal	good grief ! charlie brown actor charged
sl putting a number on smoking 's toll	well : long term effects on life expectancy from smoking
is it a coincidence the most miss america 's come from the south ?	op-ed contributor : racial politics and miss america
britain teeters toward triple-dip recession cnnmoney	britain risks new recession
million man march ; promises to bring change in bleeding pakistan- # tahirulqadri # 14jan	'million man march ' promises to paralyze pakistani capital
america , the saudi arabia of tomorrow - good luck saudi : )	america , saudi arabia of tomorrow
french twitter case involving the identities behind racist comments is only latest skirmish over internet speech	twitter ordered to help reveal sources of anti-semitic posts
" not all smoothies are created equal ! "	9 calorie bombs at restaurants
us hospitals turn away visitors with flu symptoms - nyt	hospitals place restrictions on visitors of flu patients
nytimes : 232 dead as fire sweeps through nightclub in brazil ( locked security doors and band pyrotechnics )	scores dead as fire sweeps through nightclub in brazil
v ? a supreme court hears argument on the f.c.c. ? s authority to rule on cellphone towers	supreme court hears argument on cellphone towers
iht : xiao shu , former journalist at southern weekend , gives insider take on iron grip of censorship .	op-ed contributor : dim hopes for a free press in china
# wtf it happened again . police : 7 men gang rape bus passenger in # india -	six arrested over new gang-rape on bus
# youth : the wants to know : " does # facebook ever make you feel l-o-u-s-y ? " share here	the learning network blog : student opinion | does facebook ever make you feel bad ?
da cnn : ' at least 245 killed in brazil nightclub fire update'	hundreds killed in brazil nightclub fire
horse meat discovered in hamburgers meat in uk and ireland	horsemeat found in hamburgers in britain and ireland
dear abby , dies at 94 . dear abby : are birth control pills deductible ? bertie dear bertie : only if they don ? t work .	pauline phillips , flinty adviser to millions as dear abby , dies at 94
jared diamond book worth reading ? " the world until yesterday "	? the world until yesterday , ? by jared diamond
# socialmedia makes folks more honest , says # cornell prof # facebook # linkedin	social media make us more honest
world 's best white-water rafting ? geekkenya	world 's best place for water rafting ?
casey anthony has two of her four convictions thrown out .	casey anthony convictions thrown out
workers being seen as just a cost ... we all build this society and will get what we pay for	opinionator | the great divide : the rise of the permanent temp economy
on the need for humanity in online learning .	online courses need human element to educate
weird , just the voice ? " : voice of charlie brown arrested , charged . "	good grief ! charlie brown actor charged
opinionator : misconceptions ( linda greenhouse )	opinionator : misconceptions about roe v. wade
frum : u.s. gun problem is not a race problem ( must read )	america 's gun problem is not a race problem
free speech is a basic democratic right except in france # twitter	twitter ordered to help reveal sources of anti-semitic posts
goed initiatief , inkomen op kwaliteit en niet op verrichtingen # new york city ties doctors ? income to quality of care	new york city hospitals to tie doctors ? performance pay to quality measures
art meets technology before tragedy : photog taryn simon & computer genius aaron swartz create a project , via ny times	the 6th floor blog : taryn simon and aaron swartz 's experiment with images
wow , what a story : in the subways , a voice to stir the soul	in the subways , geechee dan ? s voice stirs the soul
microsoft 's windows 8 sales are ok , not great	microsoft 's windows 8 sales are big -- just not big enough
death is bad enough :	your money : a shocking death , a financial lesson and help for others
" husbands of hollywood " ? ? gender-flipped satire of reality tv ... & subtle commentary on limited options for black actors .	critic ? s notebook : ? real husbands of hollywood ? and lack of black male leads
president hillary ! there are few things i would like more !	president hillary clinton ? if she wants it
nyt , " mouse study discovers dna that controls [ burrowing ] behavior [ and whether escape tunnels are made ] "	mouse study discovers dna that controls behavior
" : social media making us more honest ? talks to "	social media make us more honest
thinking about how we can calm down our civic discourse . labels are powerful .	opinionator | the stone : what is a ' hacktivist ' ?
public takes its shots at armstrong--what do you guys think of armstrong 's doping ?	public lashes out at armstrong
after u.s. threat , north korea turns ire on south # military # skorea # nkorea # us # politics	after threats against u.s. , north korea turns ire to south
sen. feinstein announces bill to limit semiautomatic weapons :	senator unveils bill to limit semiautomatic arms
nytimes : victory for anthony and for knicks	win for anthony and for knicks
the mexican gun-tablet exchange ...	video shows fiery copter wreckage
from : cond ? nast writer deals stir dispute # condenast	cond ? nast contracts cut author ? s share in film deals
fires threaten parts of australia -	photos : fires across australia
feel good morning read ! : ) note on a napkin , ' this meal is on us ' -	note on napkin : ' this meal is on us'
exercise can boost flu shot ? s potency # flushot # exercise # health	exercise can boost flu shot 's potency
the telecom industry just took away our rights . as of today , it 's illegal to choose a different cellphone carrier	bits blog : a right to unlock cellphones fades away
awesome ! # republicans can 't win on their ideas so they will change the rules ! ?	some gop-led states look at electoral vote changes
77 % of americans use search to find diagnosis . ? : turning to the web for a medical advice ?	well : turning to the web for a medical diagnosis
the tricks of moving from wall street to tech # dealbook	dealbook : moving from wall street to the tech sector proves tricky
should babies be left to " cry it out ? " ...	should babies just ' cry it out ' ?
interesting perspective on # broncos playcalling -	the cautious calls of john fox
rivals watch as shell 's # arctic drilling hopes hit snags . $ rds.a # alaska # keystonexl # oil # politics	rivals watch travails of shell arctic drilling
russian military ordered to switch to socks i learned something new today ! ! !	at war blog : russian military ordered to switch portyanki for socks
justice clarence thomas breaks his silence nytimes or the onion article ? can 't tell	justice thomas breaks his silence in court
interesting article . asap yams , partner to hip-hop 's asap rocky	asap yams , partner to hip-hop ? s asap rocky
they were so young : ( # santamaria # tragedyinthenightclub	hundreds killed in brazil nightclub fire
an architect is building a mobius band house with a 3d printer . i knew those things would come in handy .	architect to build home using 3-d printer
thewritinggenie supernatural tales : manuel gonzales talks about ' the miniature wife ' : mr. gonzales 's first colle ...	artsbeat : q. and a. : manuel gonzales on his story collection ' the miniature wife'
philly high schoolers , join the conversation . : would you feel safer with armed guards in your school ?	the learning network blog : student opinion | would you feel safer with armed guards patrolling your school ?
some good news for a change more lives being saved - cancer death rates drop 20 % ...	more lives being saved : cancer death rates drop 20 %
apparently a suicide	aaron swartz , internet activist , dies at 26
this is an inspiring exhibition . the way to the future . ? making room ? in the city	weekend miser : ? making room , ? at museum of the city of new york
jeanne vertefeuille , who played a key role in unmasking infamous spy aldrich ames , died recently .	jeanne vertefeuille dies , 80 ; helped catch aldrich ames
wait , what ? ! - ' universal background checks ' defined	'universal background check ' : what does it mean ?
our economic pickle : america 's productivity climbs , but wages stagnate	news analysis : america ? s productivity climbs , but wages stagnate
weak protection laws for domestic workers : saudi execution : brutal , inhuman and illegal ? - cnn # p2 # p21 # tcot # ccot	beheading : inhuman and illegal ?
reading : how to get america online via	op-ed contributor : how to get high-speed internet to all americans
new york times top public relations exec to depart	times communications executive is leaving
what 's so wrong with researching it ? what we don ’ t know is killing us	editorial : what we don ? t know is killing us
benjamin millepied to take over paris opera ballet , with all the details :	benjamin millepied to be paris opera ballet director
# java compromised take necessary action	critical java vulnerability due to incomplete earlier patch
# morsi : " nurse our children and our grandchildren on hatred for them : for zionists , for jews "	morsi says slurs of jews were taken out of context
nytimes : armstrong , a confession without explanation-the most sophisticated , organized and professionalized ? in history	for armstrong , a confession without explanation
lean in sisters .... nytimes : she ’ s ( rarely ) the boss	op-ed columnist : she ? s ( rarely ) the boss
pakistan bomb victims ' families end protest	pakistan bomb victims to be buried after protest ends
this could play out very interesting ....	some gop-led states look at electoral vote changes
senator schumer says he will vote for chuck hagel for secretary of defense good news !	schumer says he ? s satisfied with hagel on mideast
this man can sing better than some big names who will be at the grammy awards geechee dan plays the 42nd street subway	n.y. / region : geechie dan plays the 42nd street subway
security firm discovers cyber-spy campaign # itsecurity # cyberspy	bits blog : security firm discovers global spy campaign
great ny times article : “ : “ : a saint in his city : archie manning in # neworleans	a saint in his city : archie manning in new orleans
great article & comments on what biz owners face trying to figure out how to choose the right bank .	staying alive : why i 'm looking for a new bank
put up your nukes [ dukes ] ! " north korea says new nuclear test will be part of fight against u.s. " jacques	n. korea makes new threats against u.s .
calorie bomb disasters on the menu	9 calorie bombs at restaurants
icymi : " as disabled athletes compete , questions of logistics "	disabled athletes suit up , raising questions of logistics and fairness
if uv not seen # crazy # love , u should . nytimes : linda riss # pugach , whose life was ripped from headlines , dies at 75	linda riss pugach , 1937-2013 : linda riss pugach , whose life was ripped from headlines , dies at 75
question is : does this mean civil war ? probably not . but still not a good situation # iraq	sunni sheikh to al-maliki : hand over soldiers behind shootings or ' face losses'
couldn 't agree more with the facts here :	opinionator : india is losing the race
interesting article for parents who support their college kids : parents ? financial support may not help college grades	parents ? financial support linked to college grades
new york 's cuomo signs gun control bill . 1 down 49 to go !	new york to pass first gun control bill since newtown shooting
synthax _ terror 2 : : more than 800 nyc rape cases to be reviewed for forensic mistakes	more than 800 nyc rape cases reviewed for mistakes
wtf india ? ! ! this has got to stop .	six arrested over new gang-rape on bus
cnn soccer 's ' bounty hunter ' takes on fifa : a leading football agent fined by fifa for using social media has ta ...	'bounty hunter ' battles fifa on facebook
dey stay preppin ' ... the preppers next door	the doomsday preppers of new york
family uses pot to manage son 's autism ... wow	boy given pot to manage his autism
“ long island : ‘ attack of the bloodsuckers ! ’ at the long island children ’ s museum ” if you want to scare leo	arts | long island : ? attack of the bloodsuckers ! ? at the long island children ? s museum
a must read . my amazing friend cynthis schneider has done it again , bravo	opinion : u.s gets it wrong on egypt , again
why the net grieves aaron swartz - the innovator who embodied what 's best about the net .	why world grieves aaron swartz
female directors gain ground , slowly the storyteller ? s gender matters .	female film directors slowly gain ground
wtf ? ? » " : at least 245 killed in brazil nightclub fire update : "	hundreds killed in brazil nightclub fire
# cosmos unveil plan for # soccer stadium near # belmontpark # nys # ny # longisland # econdev	cosmos unveil plan for soccer stadium near belmont park
theme ? ppl trying to sell stuff that 's not theirs ... cc : # joydivision # music	lives : we were joy division
nytimes : smartphones become life ? s remote control --- amazing	smartphones can now run consumers ? lives
breaks my heart " : 245 people killed in brazil nightclub fire , police tell state news agency . "	hundreds killed in brazil nightclub fire
op-ed - why we must help save # mali # africa # helpmali	op-ed contributor : why we must help save mali
omg . at least 245 killed in brazil nightclub fire	hundreds killed in brazil nightclub fire
another gangrape in india ! wtf ! : ( 7 men gang rape bus passenger in india -	six arrested over new gang-rape on bus
social media can be a friend or foe but it doesn 't raise your iq - - police : youtube videos lead to pot bust	police : youtube leads to pot bust
he 's dead ! ? : venezuela says hugo chavez 's condition is improving ?	venezuela : chavez is improving
nytimes : tunisian style baked cauliflower frittata	recipes for health : tunisian style baked cauliflower frittata ? recipes for health
salivating ! ? : exotic culinary tours from around world ?	exotic culinary tours around the world
" still own a livestrong bracelet ? tell us about it . " ( cnn )	cycling : armstrong apologizes to staff
leave it to a lawyer from # lakechuck to get justice thomas to break his silence .	clarence thomas breaks silence on bench
# coder # outsources own job to # china for a # profit , gets fired .	u.s. man outsources job to china , surfs cat videos
africa : the top 5 stories of the week are ... -	africa 's top 5 stories this week
awkward ! notre dame linebacker says he is hoax victim	notre dame linebacker says he is victim of hoax
when pills fail , this option provides a cure for c-diff	disgusting , maybe , but treatment works , study finds
dear abby , we miss you already . how fortunate you are to have margalit fox write your obit ! " dear abby , dies at 94 "	pauline phillips , flinty adviser to millions as dear abby , dies at 94
a data crusader , a defendant and now , a cause # aaronswartz # mitfail # badbranding	aaron swartz , a data crusader and now , a cause
how an all-american hero fell to earth - . ( where have all the real heroes gone ? )	how all-american hero fell to earth
tibetan man sets himself on fire in protest . again .	tibetan sets himself on fire to protest chinese rule
more accurate ( albeit less catchy ) title would be " india is 2nd place " not " losing " , but still interesting :	opinionator : india is losing the race
awesome jeanne vertefuille told to take a secretarial course by c.i.a. she helped catch a notorious spy , dies at 80	jeanne vertefeuille dies , 80 ; helped catch aldrich ames
in awe of the courageous russian lgbt rights advocates nytimes : ‘ propaganda ’ by gays faces russian curbs amid unrest	? propaganda ? by gays faces russian curbs amid unrest
families of # newtown victims look for answers on # gun violence # nra	families of newtown school massacre victims organize against gun violence
really ? man says he 's ' certain ' where hoffa is buried	man convicted in mob crimes says he 's ' certain ' where hoffa is buried
nytimes : how to get america online - excellent op-ed by on regulating the big isps	op-ed contributor : how to get high-speed internet to all americans
time to ban nighclubs .	hundreds killed in brazil nightclub fire
'here is what happens when you cast lindsey # lohan in a movie ' & get unlimited on-set access : superb journalism .	here is what happens when you cast lindsay lohan in your movie
north korea turns its ire on the south # north # south # korea # un # sanctions # war # r2ph	north korea turns its ire on south korea
in complete shock ! catholic hospital argues fetus not a person	catholic hospital 's lawyers argue fetus not a person
armstrong 's confess ruined all the cancer survivors and cycling fans who thought his fairy-tale story was true .	for armstrong , a confession without explanation
this is what happened in brazil if you don 't know x	hundreds killed in brazil nightclub fire
although truth is a the higher standard ... : readers sue lance armstrong for book refund after doping admission	readers sue armstrong for book refund
nyt story on grounding of boeing 787s	f.a.a. orders grounding of u.s.-operated boeing 787s
aww ? : britney spears calls off engagement ?	britney spears , jason trawick call off engagement
the top baby names of 2013 - ( gee , my name is not on there ; o ) ) ) )	parenting.com 's top baby names
this shouldn 't be the problem that it is . ready-set-go . nytimes : as disabled athletes compete , questions of logistics	disabled athletes suit up , raising questions of logistics and fairness
damn smh " : death toll climbs to 220 in brazil nightclub fire , official says . "	hundreds killed in brazil nightclub fire
could it be good ? sounds intriguing ... abc to look at ' star wars ' live-action tv series -	abc to look at ' star wars ' live-action series
online courses still need a human element ...	online courses need human element to educate
gun ban argument continues but will it really solve anything except to disarm the innocent ? # pols1101	'enough is enough , ' feinstein says in proposing new gun ban
the history of temp agencies : using the sexism of the ' 60s to expand " right under the noses of powerful labor unions . "	opinionator | the great divide : the rise of the permanent temp economy
great hire by robert wolf and his new firm austan goolsbee is a great guy	robert wolf said to hire goolsbee as adviser for his firm
amen ! " : good news .... my shero robin roberts plans february return to ' good morning america ' "	media decoder blog : robin roberts plans february return to ' gma'
who stole precious relics from mo. church ?	who stole precious relics from church in missouri town ?
firefly : 2015 is happening ...... as a nasa mining vessel . # fireflyreturnskinda	'fireflies ' to scope out space rocks for mining
algerian field strike retaliation over mali , reports say -	briton killed in algerian gas field attack
i wish i could be this man # paultheroux my # travel wish list via	paul theroux ? s travel wish list
40 miles to work , on a bike : -- incredible !	commuting 40 miles to work on a bike , with thermals and fleece
oh so clever , weighs in on # obesity fight	coca-cola weighs in on obesity fight
the entrusted muslim brotherhood	egypt deploys troops to suez to quell ' out of control ' clashes
i need a ' stop day ' in my life . # cnn	the importance of a ' stop day'
great piece by " the gruesome toll of deadly # clusterbombs in syria " -	gruesome toll of cluster bombs
illuminating jewish life in a muslim empire via talmud blog	documents illuminate jewish life in ancient muslim empire
highlights from katie couric 's interview with manti te 'o	the lede blog : updates on the katie couric interview with manti te 'o
apps to help you ski : via ny times	app smart : apps helps skiers get more out of the slopes - app smart
we mourned the loss of an open access advocate this past weekend ~ a data crusader , a defendant and now , a cause	aaron swartz , a data crusader and now , a cause
nsfw ? : best obit opening i 've read in a long time . dear abby dies at 94 ?	pauline phillips , flinty adviser to millions as dear abby , dies at 94
taking foodie culture maybe a bit too far ... the unaffordable luxury of food	big city : new generation confronts unaffordable luxury of food
i 'd like to read this . mt : interview with dl weiss , who put her child on a diet and wrote about it .	motherlode blog : an interview with dara-lynn weiss , who put her 7-year-old on a diet , and wrote a book about it .
nyt botches description of " crushed beer can " fiasco in mostly v. good piece on shell 's arctic troubles	rivals watch travails of shell arctic drilling
the preppers next door who wants to join my group ?	the doomsday preppers of new york
driven by a need to compete or remorse ? armstrong admits doping , and says he will testify	armstrong admits doping , and says he will testify against cycling officials
sheriff : i won 't enforce obama 's gun laws . good for him .	sheriff won 't enforce ' unconstitutional ' gun laws
love this--forms at the doctor 's office just got fun -	forms at the doctor 's just got fun
dreamliner battery studied by ntsb ( via instapaper )	nothing ruled out as ntsb studies dreamliner battery
setting the bar , good move ! " wal-mart plans to hire any veteran who wants a job "	wal-mart to announce extensive plan to hire veterans
nytimes : apple may be big , but it isn ’ t a bellwether ( my column )	strategies : apple stock isn ? t a bellwether , even if it ? s big
schrecklich ! 😢 “ : at least 90 killed in brazil nightclub fire ”	hundreds killed in brazil nightclub fire
fortunes of facebook may hinge on search - is this the big reveal ?	fortunes of facebook may hinge on searches
what is the price of insulting the # king in # thailand ? 10 years in # prison for # activist somyot pruksakasemsuk	activist gets 10 years for king insult
sheriff : i won 't enforce obama 's gun laws he 's 1 black guy , they r us laws & calm the fuck down # overparanoia & racism	sheriff won 't enforce ' unconstitutional ' gun laws
mining electronic records for health data may greatly benefit medical research , not necessarily reduce costs of care	mining electronic records for revealing health data
nytimes : ? mad men ? set to return on april 7 . excellent news .	artsbeat : ' mad men ' set to return on april 7
greek fm : small chance greece leaves eu	greek fm : small chance of euro exit
'dad , it 's only my books i am friends with . ' # malala # womenonthefrontline	the front lines in fight for women
lovely tribute , her responses to readers ' qtns priceless . read bacon frying and you could move . dear abby dies at 94	pauline phillips , flinty adviser to millions as dear abby , dies at 94
which country has most economic freedom ? # economy # economics	country with freest economy is ...
'4-hour ' work guru on china outsourcer : bad karma - cnn international	'4-hour ' work guru on outsourcer
part 4 : answers to your questions about the # fafsa # finaid # scchat	the choice blog : part 4 : answers to your questions about the fafsa
chilling fact that the biggest safety concern for women serving in military is risk of sexual attack from comrades .	op-ed columnist : military women and the front lines
finally a little respect for vets ! wal-mart plans to hire any veteran who wants a job	wal-mart to announce extensive plan to hire veterans
" : breaking : 250 killed , 200 more injured in brazil nightclub inferno . " crazy	hundreds killed in brazil nightclub fire
" pray for me " . defense secretary panetta in audience with pope	defense secretary leon panetta meets pope
john cale in paris and along the borderline . # music	q. and a. : with john cale in paris and along the borderline
an rising star on london 's thespian scene tells his story of - being bin laden	op-ed contributor : i played osama bin laden in ? zero dark thirty ?
casting : lindsay lohan , careening debt and porn stars . what could go wrong ? what happens when you hire ll .	here is what happens when you cast lindsay lohan in your movie
saudis monsters try to defend sri lankan maid 's execution # p2 # tcot	saudis defend maid 's beheading
he nvr gives vision wo provision & he 'll use whoevr2bring it ? winfrey 's lowrated cable channel is poised 2 break through	winfrey ? s low-rated cable channel is poised to break through
a must read ! by ! how # turkey can make peace with the # kurds	op-ed contributor : how turkey can make peace with the kurds
lovely piece in the nyt on a 40-year marriage , and how their gay son ? s struggle became a unifier	making it last : conservative meets liberal , and 40-year marriage begins
what exactly is going on in mali ? @	french say airstrikes in mali ? blocked ? rebel advance
gabby and mark : the new bradys of gun control # tgdn libs play dirty as norm	the new ' bradys ' of gun control ?
nra 's video game smacks of hypocrisy # nra # guncontrol	nra 's video game hypocrisy
frum : # us . # gun problem is not a race problem	america 's gun problem is not a race problem
all from a kid starting an online petition . nytimes : pepsico will halt use of additive in gatorade	gatorade listens to a teen and changes its formula
al pacino to play joe paterno in brian de palma 's tentatively entitled film " happy valley " # sportsbiz	pacino to play paterno in film
source say at least 150 " : at least 90 killed in brazilian nightclub fire , officials say . "	hundreds killed in brazil nightclub fire
nytimes : debunking darwin . was he wrong about dating ? # sex # gender	opinion : darwin was wrong about dating
from the she owns it business group ... more thoughts on growing your business -- and helping employees	you 're the boss blog : more thoughts on growing your business - and helping employees
well , at least we know the slides work now .	boeing 787s are grounded by japanese airlines
nytimes : what we don ’ t know is killing us -couldn 't agree more ! e.g. , research on ipv homicides & guns is critical .	editorial : what we don ? t know is killing us
bho gun proposal 2 look beyond mass shootings in taking steps to completely disarm americans so that only elites prtctd	obama gun proposal to look beyond mass shootings
the deadly toll of cluster bombs in # syria	gruesome toll of cluster bombs
! pay it forward - note on a napkin , ' this meal is on us ' -	note on napkin : ' this meal is on us'
jacqui weaver tells the ny times : ? i do have friends in australia who now refer to me as ? hollywood jack ? ?	jacki weaver and the lord of greenwich village
flowers in winter ? camellias are some of my favorite prerennials .	in the garden : camellias ready for a cold snap
go # obama . obama calls for broad action on guns	obama to ask congress to toughen gun laws
is # pakistan becoming " # southasia 's # dreamliner " ? - official refuses order to arrest prime minister ashraf	pakistani official refuses order to arrest prime minister
google gains from creating apps for the # iphone # healthit # hcsm	google gains from creating apps for the opposition
i was definitely spending it on obscure sheet music and concert tickest . # misspentyouth	big city : new generation confronts unaffordable luxury of food
a generation gap ? not on this web site ( harvard business school )	a 20-something ? s web site for women over 40
eddie huang in the ny times. i vibe this dude so hard	eddie huang defies description
rangel : more equal military ? bring back draft # deployment # usaf # military	a more equal military ? bring back draft
france confronts mali jihadists	france vows to halt mali jihadists
the amount of organizations and clubs at # college is overwhelming ! choose carefully before dedicating your time :	the choice blog : lessons from a college student : finding your fit on campus
lol .. errm .. " test " on the u.s. of a. ? # damn ! : north korea says new nuclear test will be part of fight against u.s. : ?	n. korea makes new threats against u.s .
# morsi ? s slurs against # jews stir concern does any one in # obama ' s administration know how to read # english ?	morsi ? s slurs against jews stir concern
" vine is twitter 's attempt to be the instagram of video , " form a nerdier sentence . don 't try ! its impossible !	vine is twitter 's attempt to become the ' instagram of video'
mark sanford , the ex-governor of south carolina & " hiking the appalachian trail " , to run for congress	sanford , ex-governor of south carolina , to run for congress
where to go in 2013 by ! offers insightful explorations to most of these !	the 46 places to go in 2013
peter is not in the top ten but mo , bertie and gus are ? : " the top baby names of 2013 "	parenting.com 's top baby names
nytimes : # queens # school is locked down after # gun is found in 7-year-old ? s backpack is there no end ?	gun found in 7-year-old ? s backpack at queens school
what choo talkin ' bout mr. d ...... rip conrad bain , father on ? diff ? rent strokes ? , dies at 89	conrad bain , actor on ? diff ? rent strokes , ? dies at 89
facebook unveils new search tool :	bits blog : facebook unveils a new search tool
# gunreform for a generation	editorial : president obama ? s plan for gun reform
is it me , or is the main ingredient in coke sugar ? in ads , coke confronts soda ? s link to obesity	coke tv ads confront obesity and soda ? s role
excellent analysis of the housing market recovery - housing offers hope of strength in the economy	high & low finance : signs of a housing recovery point to a stronger economy
williams starts fast , but pace suits rockets	williams starts strong , but nets don ? t follow in loss to rockets
quebra tudo ! ! ! j.j. abrams to direct next ‘ star wars ’ movie	j.j. abrams to direct next ' star wars ' movie
wow : announcing plan to hire every veteran who wants a job - w a few conditions . they anticipate 100k + hires :	wal-mart to announce extensive plan to hire veterans
in britain , basketball can be a tough sellwhy would brits get excited bout pro bb , they got " football " 2 keep them bored .	in britain , basketball is somewhat of a tough sell
at least 90 killed in brazil nightclub fire " kropp left that country in the nick of time .	hundreds killed in brazil nightclub fire
dutch automat returning zing to dutch cooking	putting spice into dutch cooking
man held after subway attack in philadelphia omg !	man held after woman thrown onto subway tracks in philadelphia
who decides the laws of war ? it belongs in civilian courts .	news analysis : military tribunals and international war crimes
former alaska gov sarah palin is no long a commentator for fox news	fox news and sarah palin part ways
new york lawmakers agreed on changes to gun laws ills	new york legislators hope for speedy vote on new gun laws
lance armstrong [ finally ] admits doping , says he will testify	armstrong admits doping , and says he will testify against cycling officials
hong kong takes the internet speed title with 54.1 mbps .	hong kong takes internet speed title
where is justice ? ' they ran him over because he was black'	victim 's son : it was a hate crime
reflects on doctors who take time off & then start seeing patients again .	doctor and patient : when the doctor returns to doctoring
sheen wants to return to ' 2.5 men ' but has his past image ruined that ? # coepr205	sheen wants to return to ' two and a half men'
good read : challenges for women in india :	challenges of being woman in india
nytimes : richard g. stern , writers ? writer , dies at 84 big loss	richard g. stern , a writers ? writer , is dead at 84
fantastic read from on imprtnce of narratives : " ... stories , not algorithms , give order to our hectic world . "	opinion : tv , the thinking person ? s entertainment of choice
" 2012 : the year of extreme # weather " : # climatechange # drought # nationalclimateassessment # globalchangeresearch	iht rendezvous : 2012 : the year of extreme weather
la vision am ? ricaine sur m.kaspersky est peu flatteuse security firm discovers cyber-spy campaign	bits blog : security firm discovers global spy campaign
sweet , sweet story . nytimes : a doll ? s magic , free to renew	a doll 's magic , free to renew
a new housing boom ? don ’ t count on it - by robert j. shiller -	a new housing boom ? don ? t count on it
" ( uk fave ) " mate , why don 't skip killing people night ? it 's too cold . " -nyc murderers in last 9 days	cold wave cut murders in new york city significantly
take that texas . white house rejects petitions to secede , but texans fight on	texas secession movement unbowed by white house rejection
no deal on teacher 's union evaluations ; nyc risks losing $ 450 million	new york city talks on teacher evaluations
interesting perspective ... nytimes : a new housing boom ? don ’ t count on it	a new housing boom ? don ? t count on it
battle behind china 's ' firewall'	working behind china 's ' great firewall'
nytimes : analysis of armstrong ? s interview with winfrey it 's shame ( but we know it ) # congrutalionlance	the lede blog : live updates on armstrong 's oprah interview
too many s * tty men in india : another gang rape	six arrested over new gang-rape on bus
vodka is saving lives ! well , a puppy 's life ...	booze saves puppy 's life
jl # nyt : u.s. military stops sending some detainees to afghan custody # p2 # topprog	u.s. military stops sending detainees to some afghan prisons on rights fears
loving the street style from the # couture in # paris # fashion	t magazine : street style from the couture in paris
asked many people ( including yours truly ) if # lancearmstrong deserves another chance . interesting views	give lance another chance ?
travel photos that you wish you had taken -	today 's photo : thai temple
# pentagon to lift combat ban for women ... how about banning combat for men ? ?	pentagon lifting ban on women in combat
doing good ( and burnishing images too ) # celebrity # charity	the carpetbagger : doing good ( and burnishing images , too )
iran currency falls further on u.s pressure over banks transactions	iran currency falls further on concerns over bank
'kitty cams study found that four of the cats were two-timing their owners , ' and more in this cat story .	well pets : holly the cat 's incredible journey
union membership falls to 97-year low , 11.3 % . people will still find ways to blame them for everything .	union membership drops despite job growth
who spends so much money on food ? that 's so retarded : ) the unaffordable luxury of food	big city : new generation confronts unaffordable luxury of food
sent from the cnn app for android at least 245 killed in brazil nightclub fire	hundreds killed in brazil nightclub fire
# google gains from creating apps for # iphone . google maps is # 1 # app .	google gains from creating apps for the opposition
get it together sun ( # oracle ) ! homeland security warns users to disable java . # cybersecurity	disruptions : u.s. agency warns of java software problem
unreal ? : if you have not heard of the acid attack on the bolshoi director . ?	acid attack on russia ballet director
tragic . my thoughts and prayers go out to all ... " at least 220 killed in brazil nightclub fire "	hundreds killed in brazil nightclub fire
potentially explosive legal battle : catholic hospital argues fetus not a person	catholic hospital 's lawyers argue fetus not a person
kyle stanley gained from pain of squandered lead at torrey pins : kyle stanley this week is back at torrey pines , ...	kyle stanley gained from pain of squandered lead at torrey pines
scarcity and financial decision-making .	hanging on : in debt , and digging deeper to find relief
holy crap ! : ( " 2 killed as helicopter crashes into crane in central london "	helicopter crashes in london rush hour
u.s. single-malt # whiskey has arrived	american single-malt whiskeys serve notice
allergy-bullying ? apparently this is a real problem .	allergy bullying : when food is a weapon
world awaits oprah 's armstrong interview not me i 'm not watching	world awaits oprah 's lance armstrong interview - but will it change anything ?
homicide # 2 cause of death in 15-24-yr-olds in us- 4 out of 5 of these deaths from guns	america flunks its health exam
a library doll is loaned out to children :	a doll 's magic , free to renew
senate holds key to fixing washington - thanks for that insight ari # p2 # tcot	senate key to fixing washington
# cuba restricts travel for ' skilled ' people	cuba limits travel for athletes , workers
what is driving our growth in government spending # facts	what is driving growth in government spending ?
it 's a start ! kudos to this kid ! ! ! pepsico will halt use of additive in gatorade	gatorade listens to a teen and changes its formula
obama-backed gun bills a long shot . " this is one issue that me and the president happen to agree on . "	reform is a long shot in current congress
beyond the media 's coverage of her emotions , # clinton put out good info : five things we learned from benghazi hearings	5 things we learned from benghazi hearings
2 # france : we 're not the pacifists you think	why france is not pacifist nation
change the rules = prez romney : “ : electoral college changes would pose danger 4 democrats ”	fivethirtyeight : electoral college changes would pose danger for democrats
as seen on tv ! ~ black and famous but out to pasture	critic ? s notebook : ? real husbands of hollywood ? and lack of black male leads
: report : 650 hostages freed by algeria forces	fear , confusion in algerian hostage crisis
pray they 'll stay together for the right reasons - kobe bryant , wife calling off divorce -	kobe bryant and wife call off divorce
harrowing stories : broken limbs , torn lives in northern # mali	broken limbs , torn lives in mali
# nhl players begin voting on labor deal ; approval expected by saturday # abasal # antitrust	slap shot : n.h.l. players begin voting on labor deal ; approval expected by saturday
over 50 , and under no illusions over 50 ? invent yourself everyday !	how 5 older workers saw a chance to remake their careers
the power of user reviews - wielded for good or evil ? nytimes : swarming a book online	a casualty on the battlefield of amazon ? s partisan book reviews
cool stuff : 6 trends we saw at ces 2013 -	6 trends from ces 2013
at least 233 dead in brazilian nightclub fire . : (	hundreds killed in brazil nightclub fire
so sad news : 245 people killed in brazil nightclub fire .	hundreds killed in brazil nightclub fire
ouch , possibly ? “ : nytimes : japan ’ s business culture hovers over boeing ’ s battery choice ”	common sense : selection of the boeing 787 ? s battery maker raises questions
what a loss of a great & inspirational mind ! internet activist , a creator of rss , is dead at 26 , apparently a suicide	aaron swartz , internet activist , dies at 26
it 's jail time , charlie brown	good grief ! charlie brown actor charged
at long last , the truth ... armstrong admits doping , and says he will testify	armstrong admits doping , and says he will testify against cycling officials
i am calling bs ! ! ! nytimes : morsi says his slurs of jews were taken out of context	morsi says slurs of jews were taken out of context
if you 're a skier or snow-boarder , you 'll dig these : on snowy slopes , fingers glide down the touch screen .	app smart : apps helps skiers get more out of the slopes - app smart
david gergen says obama 's 2nd inaugural will deepen division . # didn 'tseeitcoming	was obama 's historic speech divisive ?
please read : ' s piece on the gruesome toll of deadly cluster bombs in # syria :	gruesome toll of cluster bombs
# csis388 _ dave facebook disrupting online dating	how facebook 's graph search could disrupt online dating
u.s. steps up involvement in mallpp # pppj # # p # pl # # # p # # # p	u.s. steps up involvement in mali
i went after guns . obama can , too . one of the only things i would agree with howard on .	op-ed contributor : australia banned assault weapons . america can , too .
so wang lijun did build a surveillance network . - chinese party and business officials fired in sex scandal	chinese officials fired over sex scandal
nytimes : she ’ s ( rarely ) the boss smart , as usual	op-ed columnist : she ? s ( rarely ) the boss
wow " : at least 245 killed in brazil nightclub fire update : "	hundreds killed in brazil nightclub fire
hot # luxury news : japanese airlines suspend dreamliner flights after emergency land ? , see more	japanese airlines suspend dreamliner flights after emergency landing
everyone should read ' s cnn column from today :	america 's gun problem is not a race problem
# breaking : # police clash with # protesters calling for dissolution of # pakistan 's government -	police , protesters clash in pakistan
mubarak goes to jail	egypt 's hosni mubarak faces retrial
honestly where are people 's rights being ruined in obama ? s gun control proposal	what ? s in obama ? s gun control proposal
this is odd ! tsk ! - catholic hospital argues fetus not a person	catholic hospital 's lawyers argue fetus not a person
great to have in the press pool to discuss his piece on the president 's push for gun control .	biden meets with house democrats on gun-violence proposals
the classic american fame and blame game . the point of lance	op-ed columnist : the point of lance armstrong
# djokovic sets sights on # paris party	djokovic : 3 aussie wins in a row
# pakistan ’ s premier intervenes in fire inquiry	pakistan ? s ashraf intervenes in fatal fire investigation
kinship care & siblings : after # fostercare yrs , a woman becomes a role model for her sisters	the neediest cases : after foster care , becoming a role model for her sisters
looks like we could get something right	gop balks at gun control proposals
you should read this : the lifting of a veil , discreetly	the tv watch : jodie foster lifts a veil at golden globes
interesting piece ! being bin laden # films # zerodarkthirty	op-ed contributor : i played osama bin laden in ? zero dark thirty ?
u ds boi ehn " : piers slams guest over ar-15s "	piers , guest clash over ar-15s
bad tweet ( news ) of the day " : for rape victims in india , police r often part of problem reports "	for rape victims in india , police are often part of the problem
these law enforcers will stop at nothing	movie review : ? gangster squad ? with sean penn , ryan gosling and emma stone
populist without a backbone elected by popular vote supported by heavy media campaign # zeman # czechrepublic	former prime minister is elected president of czech republic
artley : getting 10 million twitter followers	how to get 10 million followers on twitter
hmmm she 's filing for bankruptcy ..	casey anthony files for bankruptcy
# mali need not be france ? s afghanistan	iht rendezvous : mali need not be france 's afghanistan
war on evil ? war on sociopaths ? banning guns sounds like it will work a lot better than that war on drugs stuff .	obama gun proposal to look beyond mass shootings
be safe. i 've heard on the news about china 's air pollution that is terrible	china allows media to report alarming air pollution crisis
a heroic doctor returns to congo	doctor returns to congo and is hailed as a hero
nytimes : d. brainerd holmes , a leader in space race , dies at 91	d. brainerd holmes , top nasa official , dies at 91
179 republicans vote no ... house approves $ 50.7 billion in emergency aid for # sandy victims	house approves $ 50.7 billion in emergency aid for storm victims
nobel-winning economist on why we should care about # climate change .	on the non-equivalence of greenhouse gases and entitlement spending
nyt most emailed : pentagon set to lift ban on women in combat roles : the groundbreaking decision overturns a 199 ...	pentagon lifting ban on women in combat
it is laughable to believe the whole story , they never met ? image becomes a puzzle as theories on te ? o swirl	image of manti te ? o becomes puzzle as theories swirl
who 'd have thought an american hero could be a canadian ? nyt : man who sheltered americans in tehran , dies at 88	john sheardown , canadian who sheltered americans in tehran , dies at 88
'vampire diaries ' spinoff coming to the cw , it 's based in nola !	'vampire diaries ' spinoff pilot coming to the cw
poor creature mt amid 2d-guessing , marine rescuers decide not to remove stricken dolphin from gowanus canal .	the hard decision not to rescue an ailing dolphin
cnn : egypt clashes : a stern egyptian court ruling tied to a soccer riot spurred clashes that left at least 30 pe ...	egypt deploys troops to suez to quell ' out of control ' clashes
lance armstrong quotes , pure gold	lance 's classic quotes
gas prices creep up a bit	gas prices tick up slightly
indian star ( sania mirza ) tells of life and marriage in media fishbowl	straight sets : indian star tells of life and marriage in media fishbowl
parent is defined as a point of origin . i 'm not done being the best parent i can be for ben . not by a very long measure	families of newtown school massacre victims organize against gun violence
new # facebook changes afoot - not to your profile ( phew ! ) - rather a new feature , # graphsearch .	facebook introduces ' graph search'
parsing what jodie foster did ( and didn 't ) say gotta be honest : i had not idea what she was saying . # goldenglobes	the carpetbagger : parsing what jodie foster did ( and didn 't say )
aaron swartz , internet activist and a creator of rss , is dead at 26 , apparently a suicide .	aaron swartz , internet activist , dies at 26
mt : ny health chief defends decision not to evacuate hospitals \ \ the importance of disaster om	new york health chief defends decision not to evacuate hospitals
a case when you might want to take someone else 's shit ...	disgusting , maybe , but treatment works , study finds
good article on the economics & culture that fuels pro cycling . nytimes : looking upstream in doping cases	critics take a look upstream in doping scandals
# wal-mart plans to hire any # veteran who wants a # job	wal-mart to announce extensive plan to hire veterans
awful way to go out ... " : at least 220 killed in brazil nightclub fire "	hundreds killed in brazil nightclub fire
the importance of taking a day off	the importance of a ' stop day'
care of the elderly : the opportunity of food is more than meals on wheels .	study : more to meal delivery than food
nytimes : talking , walking objects ( this is a fantasy world for geeky me )	opinion : our talking , walking objects
i think a bunch of uci suits need to change their pants nytimes : armstrong admits doping , and says he will testify	armstrong admits doping , and says he will testify against cycling officials
what a dope ( r ) ... nytimes : armstrong admits doping , and says he will testify	armstrong admits doping , and says he will testify against cycling officials
'million man march ' threatens # pakistan capital - cnn ,	'million man march ' promises to paralyze pakistani capital
this is gonna be fantastic for entertainment :	? south park ? creators to start company , important studios
" : voice of charlie brown arrested , charged . " please tell me he said good grief ...	good grief ! charlie brown actor charged
, is this anti-free speech new french law about twitter must identify racist , anti-semitic posters , via	french court : twitter must identify racist users
flu season is here , let 's clear something up : " do i need a flu shot if i ? ve had the flu ? "	ask well : do i need a flu shot if i 've had the flu ?
kobe bryant , wife say they are calling off # divorce -	kobe bryant and wife call off divorce
inspiring article by chelsea clinton about volunteering this saturday - national day of service	clinton : we can make a difference
did you read the # opinionator the relationship between parents & teachers ? liza lee was interviewed . # edchat	opinionator | schooling : the dicey parent-teacher duet
mt design now rivals technology in importance	disruptions : disruptions : design is driving technology forward
uhhhh 10 reasons we can 't get enough gosling yummie	why we can 't get enough gosling ( duh ! )
java vulnerability due to incomplete patch ( from )	critical java vulnerability due to incomplete earlier patch
nytimes : great obit on dear abby .	pauline phillips , flinty adviser to millions as dear abby , dies at 94
robots making us more competitive in manufacturing :	robot makers spread global gospel of automation
florida 's burmese python issue leads to snake killing contest . - ...	florida tackling python problem with hunting contest
homicide tracking site expanding to # chicago love it . great call & congrats	media decoder blog : homicide tracking site expanding to chicago
180 ! “ : at least 90 killed in brazil nightclub fire ”	hundreds killed in brazil nightclub fire
are you better off " playing for a tie " in # investing :	strategies : in investing , at least , it makes sense to play for a tie
boost your flu shot response with exercise	exercise can boost flu shot 's potency
for obama ? s new term , start here - nick kristof for nyt	op-ed columnist : for obama ? s second term , start here
worst nightmare ! " : at least 245 killed in brazil nightclub fire update : "	hundreds killed in brazil nightclub fire
anyone tried this ? ? amazon giving you free mp3s your cds	amazon giving you free mp3s of your cds
damn , maybe i shouldn 't be so sanguine about the london fog :	helicopter crashes in london rush hour
# nyc school bus drivers go on strike nyc school bus corruption & in some cases organized crime	new york school bus drivers go on strike
how about a path to # citizenship for those already caught crossing the # border ? # citizenship path in one fast push	obama will seek citizenship path in one fast push
good read . agree - mostly " : parents ? financial support may not help college grades "	parents ? financial support linked to college grades
j.j. abrams set to direct ? star wars : episode vii ?	j.j. abrams to direct next ' star wars ' movie
to face someone that already shot a student .. " : i 'm no hero , says teacher who talked down armed student . "	teacher talks armed student into giving up , police say
( ) brazil hosts largest fag parade in the world . # fagsdoomnations 245 people killed in brazil club fire .	hundreds killed in brazil nightclub fire
tea party unhappy . fox news fires sarah # palin	fox news and sarah palin part ways
on point ... 5 wine words not to fear	the pour : in describing wines , 5 words not to fear
see also : nytimes : in quebec , a celebration on skis	in quebec , a winter celebration on skis
life begins at conception , unless cas is involved .	catholic hospital 's lawyers argue fetus not a person
this would be a very , very bad idea dprk . north korea threatens south korea ove un sanctions :	north korea turns its ire on south korea
in n.a.a.c.p. , industry gets ally against soda ban hmmmmmmmm . . . .	in court , n.a.a.c.p. adds voice against bloomberg ? s soda ban
about damn time ! ! ! new york governor signs nation 's first gun-control bill since newtown -	new york to pass first gun control bill since newtown shooting
unemployment in # spain climbs again , with no relief in sight ...	spanish joblessness climbs again , with no relief in sight
timothy cook , apple ? s ceo , said the pipeline of products was ? chock-full . ? ? we feel great about what we have in store ?	apple ? s profits are flat , and stock drops
read that facebook has launched a new tool ( ) to search its huge database of social graph data .	bits blog : facebook unveils a new search tool
don 't know why i can 't stop reading about him - a data crusader , a defendant and now , a cause	aaron swartz , a data crusader and now , a cause
i wish i could see this , it sounds cool ! second stage adds ' nobody loves you'	artsbeat : second stage theater adds ' nobody loves you'
nytimes : # lindarisspugach , whose life was ripped from headlines , dies at 75 # crazylove	linda riss pugach , 1937-2013 : linda riss pugach , whose life was ripped from headlines , dies at 75
3d version of ? top gun ? was rejected by # china 's censors . the line " religion is darkness ' in " life of pi " gt the x too	in hollywood movies for china , bureaucrats want a say
. kobe just saved about $ 100 mil	kobe bryant and wife call off divorce
ny times communications executive bob christie is leaving . one of the industry 's few good spokespeople .	times communications executive is leaving
rip i have no words : ( at least 245 killed in brazil nightclub fire -	hundreds killed in brazil nightclub fire
property values : what you get for ... $ 1.6 million	property values : real estate for $ 1.6 million
# twolves fans should read this piece on kg by in the nytimes	either with him or against him
india is a shockingly bad place to be a woman - how can it be so backwards ? ?	india ? s new focus on rape shows only the surface of women ? s perils
be careful what you eat -- particularly at restaurants ! ! !	9 calorie bombs at restaurants
# britain ’ s prime minister defends decision to seek vote on # europeanunion	u.k. prime minister defends decision to seek e.u. vote
where in the world is àfrica ? selection of the boeing 787 's battery maker raises questions	common sense : selection of the boeing 787 ? s battery maker raises questions
women have ' taken their posts with such seamless calm that the country barely noticed . ' 	op-ed columnist : military women and the front lines
justice thomas hasn 't said a single word in the supreme court in 7 years.he broke his silence.he said " well he did not "	justice thomas breaks his silence in court
kids can 't trust anyone ! ! " : 50 arrested in florida child sex sting - including several teachers : "	teachers among 50 arrested in child sex sting
pentagon to lift combat ban	pentagon ends ban on women in combat
u.s. , other nations ground boeing dreamliners over fire risk ( cnn )	u.s. , other nations ground dreamliners
i don 't normally agree with former pm john howard - but he is spot on about gun control in the us	op-ed contributor : australia banned assault weapons . america can , too .
need a rubber stamp of chairman mao or lady godiva on her horse ? ink pad in the w. village has got ' em . # nabejoint	neighborhood joint | west village : 10,000 rubber stamps at ink pad in the west village
he arts beat producer says james brown biopic is finally a go : the producers says he 's gotten the rights from th ...	artsbeat : james brown biopic finally gets go ahead
this is interesting - nytimes : parents ? financial support may not help college grades	parents ? financial support linked to college grades
ishikawa and wiratchant invited to augusta	ryo ishikawa and thaworn wiratchant get invites to masters
great idea " : should make capital gains regressive over time , based upon how long capital invested # startupact "	are we living the capitalist 's dilemma ?
pentagon breaking news , this going to be a big debate .	pentagon to open combat jobs to women
omo dey go tey : opinion : nigerians still waiting for their ' african spring ' sowore -	nigeria waits for ' african spring'
not in my diet but hamburger eaters should be aware * horsemeat found in hamburgers in britain & ireland -	horsemeat found in hamburgers in britain and ireland
online internet aaron swartz commits suicide , relative says	online activist aaron swartz commits suicide
got a flu shot ? exercising can make it work even better. from	exercise can boost flu shot 's potency
for # armstrong it 's about rebuilding a revenue stream the same as always . # doprah	for armstrong , a confession without explanation
disruptions : design rivals technology in importance : nice quotes !	disruptions : disruptions : design is driving technology forward
before there was dear sugar , there was deary abby : pauline phillips , flinty adviser to millions , dies at 94	pauline phillips , flinty adviser to millions as dear abby , dies at 94
" france is increasing security at sites in # niger and at home . " # uranium # mali	france is increasing security at uranium sites in niger
on trial over the illegal use of sea unicorn parts : # dailywhale	2 linked to smuggling narwhal tusks plead not guilty
n. korea defiant on u.n. sanctions	u.n. security council slams north korea , expands sanctions
training tips from star athletes # motivation # fitness	personal best : training insights from star athletes
interesting article ! she ’ s ( rarely ) the boss	op-ed columnist : she ? s ( rarely ) the boss
christensen : we are living capitalist 's dilemma	are we living the capitalist 's dilemma ?
the ginger in me loves that world 's # 1 bachelor is part of the # gingerfamily	prince harry most eligible bachelor
: - \ hmv gone into bankruptcy equivalent ...	dealbook : british retailer hmv enters equivalent of bankruptcy
really people ? ? ? ? : readers sue lance armstrong for book refund after doping admission ?	readers sue armstrong for book refund
british woman sentenced to death in bali drug case	british grandmother sentenced to death for smuggling cocaine into bali
daily review : selected letters of william styron # review	? selected letters of william styron ?
