render one language in another language	restate ( words ) from one language into another language .
nations unified by shared interests , history or institutions	a group of nations having common interests .
convert into absorbable substances , ( as if ) with heat or chemical process	soften or disintegrate by means of chemical action , heat , or moisture .
devote or adapt exclusively to an skill , study , or work	devote oneself to a special area of work .
elevated wooden porch of a house	a porch that resembles the deck on a ship .
either half of an archery bow	either of the two halves of a bow from handle to tip .
a removable device that is an accessory to larger object	a supplementary part or accessory .
restrict or confine	place limits on ( extent or access ) .
orient , be positioned	be opposite .
bring back to life , return from the dead	cause to become alive again .
anything illusory , not concrete or real	something with no concrete substance .
a name or trait that identifies a product or type of thing	a name given to a product or service .
the processing or operation of something	a set sequence of steps , part of larger computer program .
line , cover	cover the front or surface of .
determine a standard ; estimate a capacity or measurement	estimate the value of .
an interpretation , an account or reading of an event or situation	a mental representation of the meaning or significance of something .
festive social event , celebration	an occasion on which people can assemble for social interaction and entertainment .
make fine adjustments to for optimal operation ; adjust to a certain scale .	make fine adjustments or divide into marked intervals for optimal measuring .
a short lyric or poem intended to be sung	a narrative song with a recurrent refrain .
effectively wield or manipulate a concrete entity	handle effectively .
employ or become employed in a position	appoint someone to ( a position or a job ) .
group of people defined by a specific profession	organization of performers and associated personnel ( especially theatrical ) .
storage cabinet furniture	office furniture consisting of a container for keeping papers in order .
signal ( approval or interest ) by winking ; briefly shut one eye .	signal by winking .
capital stock in a corporation	any of the equal portions into which the capital stock of a corporation is divided and ownership of which is evidenced by a stock certificate .
prove or corroborate	establish or strengthen as with new evidence or facts .
( the content of ) a communication .	a communication ( usually brief ) that is written or spoken or signaled .
a partial denture	a denture anchored to teeth on either side of missing teeth .
move to a lower position , terminate something	terminate an association with .
flow , as of liquids	reduce or cause to be reduced from a solid to a liquid state , usually by heating .
seal , insulate or protect	treat the body or any part of it by wrapping it , as with blankets or sheets , and applying compresses to it , or stuffing it to provide cover , containment , or therapy , or to absorb blood .
scar physically ; create a mark on someone or something	make underscoring marks .
surround completely ; close in , as if with a covering or border .	surround completely .
the act or event of ending a process , state , situation	the end of a word ( a suffix or inflectional ending or final morpheme ) .
the price of a good or service	an assertion that someone is guilty of a fault or offence .
depict or portray in art , words , or model	create an image or likeness of .
travel in or be shaped like a zigzag	bend into the shape of a crank .
annoy , harass , or mock , perhaps playfully .	mock or make fun of playfully .
( cause to ) smell bad .	be extremely bad in quality or in one 's performance .
social ranking or position	the relative position or standing of things or especially persons in a society .
ponder , consider , observe carefully	consider in detail and subject to an analysis in order to discover essential features or meaning .
persuade or achieve acceptance	persuade somebody to accept something .
physical matter left behind after a removal process	matter that remains after something has been removed .
any tall , vertical shape	anything that approximates the shape of a column or tower .
physically inflate	become inflated .
heavy radioactive metallic element , atomic number 92	a heavy toxic silvery-white radioactive metallic element ; occurs in many isotopes ; used for nuclear fuels and nuclear weapons .
complain about something or say mean things to someone .	say mean things .
care about , be bothered by , be concerned by	be offended or bothered by ; take offense with , be bothered by .
the tallied points of a game , at a given time	a number that expresses the accomplishment of a team or an individual in a game or contest .
edit so as to block the truth ; prevent distribution	subject to political , religious , or moral censorship .
a casual , brief meeting with someone	a casual or unexpected convergence .
an electrical connection between conductor and earth	a connection between an electrical device and a large conducting body , such as the earth ( which is taken to be at zero voltage ) .
an agent 's act of terminating an activity or event	the act of ending something .
notable or famous persons ( real or fictional )	a well-known or notable person .
a person who manipulate or controls a device or machine	an agent that operates some apparatus or machine .
find , determine the place of	determine or indicate the place , site , or limits of , as if by an instrument or by a survey .
to engage in plotting or activities of an illegal or deceitful nature	act in unison or agreement and in secret towards a deceitful or illegal purpose .
be equivalent , have the same effect as something	be tantamount or equivalent to .
( cause to ) survive	cause to move by pulling .
the money	a voluntary gift ( as of money or service or ideas ) made to some worthwhile cause .
a sudden emotional vocalization	a loud utterance of emotion ( especially when inarticulate ) .
go back , restore , revive	go back to a previous state .
settlement of people distant from their homeland	a body of people who settle far from home but maintain ties with their homeland ; inhabitants remain nationals of their home state but are not literally under the home state 's system of government .
( the discovery or exhibition of ) factual evidence that establishes the truth of something .	a formal series of statements showing that if one thing is true something else necessarily follows from it .
enter a realm , become involved with	cause to move ; cause to be in a certain position or condition .
a project or undertaking	earnest and conscientious activity intended to do or accomplish something .
a standardized system of measurements for heaviness	a system of units used to express the weight of something .
a concern or affair	some situation or event that is thought about .
have a strong sexual attraction to	feel or have a desire for ; want strongly .
a surrogate expression , utterance for a taboo word	a blank character used to separate successive words in writing or printing .
facility for secure storage of things , often money	a facility where things can be deposited for storage or safekeeping .
emit or cause to emit noise	make a certain noise or sound .
make physical contact with , possibly with the effect of physically manipulating .	cause to be in brief contact with .
find out or be informed of a new information , understand or realize	get to know or become aware of , usually accidentally .
head of a country	the chief executive of a republic .
touch with the lips .	touch with the lips or press the lips ( against someone 's mouth or other body part ) as an expression of love , greeting , etc ..
a natural physical force of drawing towards something	the force used in pulling .
a change which is a decrease	a gradual decrease ; as of stored charge or current .
an evaluation , an estimation of worth , a grade	a number or letter indicating quality ( especially of a student 's performance ) .
having responsibility for managing or supervising	an impetuous rush toward someone or something .
fail or suffer failure	suffer failure , as in some enterprise .
an abundance of something	the property of copious abundance .
an authoritative text or the corresponding citation .	a short note recognizing a source of information or of a quoted passage .
an instance of visual perception .	( often followed by `of ' ) a large number or amount or extent .
fluctuate , move back and forth	sway to and fro .
the alleviation of distress	a change for the better .
a ceremony marking admission into a religious community .	a sacrament admitting a baptized person to full participation in the church .
a social gesture of deferential greeting	a courteous expression ( by word or deed ) of esteem or regard .
move to a new location , state , or situation	cause ( a computer ) to execute a single command .
change one for another	give to , and receive from , one another .
a full stop , as a punctuation mark	a punctuation mark ( . ) placed at the end of a declarative sentence to indicate a full stop or after abbreviations .
something that is craved	something craved , especially an intravenous injection of a narcotic drug .
to grow rapidly	increase rapidly and in an uncontrolled manner .
speak in a high-pitched tone of voice , as either an animal or human might .	make high-pitched sounds .
domesticated animals kept for use or profit	a special variety of domesticated animals within a species .
a discipline , a branch of knowledge	the discipline that records and interprets past events involving human beings .
a person who is aggressively pursued , chased	a person who is the aim of an attack ( especially a victim of ridicule or exploitation ) by some hostile person or influence .
personnel casualty	military personnel lost by death or capture .
escape or avoid a situation or responsibility	use cunning or deceit to escape or avoid .
a relative loss in price , value	a loss entailed by giving up or selling something at less than its value .
a measurable or quantitative decrease	a sudden sharp decrease in some quantity .
change the key , pitch , tone , or volume of , likely for aesthetic reasons .	change the key of , in music .
a written message of nonacceptance	a message refusing to accept something that is offered .
( cause to ) stop speaking or bring about silence	move so that an opening or passage is obstructed ; make shut .
injure , scratch the surface	cut the surface of ; wear away the surface of .
a plant structure near the top of the plant .	a fruiting structure resembling an umbrella or a cone that forms the top of a stalked fleshy fungus such as a mushroom .
a written list of particular things being offered	a list of particulars ( as a playbill or bill of fare ) .
a notational mark used in writing , diacritic	a diacritical mark used to indicate stress or placed above a vowel to indicate a special pronunciation .
the state of believing in , or having confidence in , something or someone	the trait of believing in the honesty and reliability of others .
an attempt or effort to achieve a goal	an attempt to get something .
increase in amount , extent , or intensity	go up or advance .
clean , wash thoroughly	clean with hard rubbing .
compress out of shape or into small pieces	become injured , broken , or distorted by pressure .
point or direct object , weapon , or blow at something or someone	point or cause to go ( blows , weapons , or objects such as photographic equipment ) towards .
employ or utilize , put into service	give or convey physically .
spin , wind , braid , or twist together , perhaps as when performing lacework .	do lacework .
a decorative container , often for holding flowers	an open jar of glass or porcelain used as an ornament or to hold flowers .
preserve , keep in safety , use frugally	preserve with sugar .
an open motorboat used for transport	a motorboat with an open deck or a half deck .
a process of development , increase or advancement	a process of becoming larger or longer or more numerous or more important .
make sure of .	be careful or certain to do something ; make certain of something .
supply or furnish with something needed or wanted	give something useful or necessary to .
a sharp bladed instrument for shaving off hair	edge tool used in shaving .
learn , assimilate a body of knowledge	learn by reading books .
support ; hold up ; nurture or provide for	lengthen or extend in duration or space .
keep away , prevent from happening , or not do something	refrain from doing something .
something that provides advice .	something that provides direction or advice as to a decision or course of action .
the act of copying the actions of someone else .	a representation of a person that is exaggerated for comic effect .
a physical entity	a separate and self-contained entity .
lessen in force , impact , or effect	make less severe or harsh .
a judgement or opinion about something	a judgment of the qualities of something or somebody .
flog or whip	beat severely with a whip or rod .
act , form , or progress according to a plan or ideal	shape or influence ; give direction to .
germinate , as in a plant .	produce buds , branches , or germinate .
social sphere , scope of activity or interest	a particular environment or walk of life .
a static vertical layout , e.g. text or numbers	a vertical array of numbers or other information .
recognize , be familar or well-versed with	be cognizant or aware of a fact or a specific piece of information ; possess knowledge or information about .
a portrayal of someone or something , through words or behavior	any likeness of a person , in any medium .
a device to control the rate of some activity , e.g. , chemical or mechanical	any of various controls or devices for regulating or controlling fluid flow , pressure , temperature , etc ..
form an aesthetic or conceptual whole .	cause to form a united , orderly , and aesthetically consistent whole .
human legs , informal usage	informal terms for the leg .
goal or objective	the goal intended to be attained ( and which is believed to be attainable ) .
protect from heat , cold , or other detrimental conditions	place or set apart .
an allotment or percentage of something	assets belonging to or due to or contributed by an individual person or group .
something that attains victory	an event that accomplishes its intended purpose .
line up or make parallel ; bring into proper adjustment	place in a line or arrange so as to be parallel or straight .
a home furnishing that is a fabric cover	bedclothes consisting of a lightweight cloth covering ( an afghan or bedspread ) that is casually thrown over something .
meshed frame over windows and doors	a protective covering consisting of netting ; can be mounted in a frame .
a measure of the likelihood or probability of an event	a measure of how likely it is that some event will occur ; a number expressing the ratio of favorable cases to the whole number of cases possible .
anyone who judges or finds fault with something .	someone who frequently finds fault or makes harsh and unfair judgments .
the rescue or release of someone , something	recovery or preservation from loss or danger .
observe , perceive	observe with care or pay close attention to .
limit , keep under control , deter , forbid	to compel or deter by or as if by threats .
stick out , jut out , protrude	extend out or project in space .
to act as the host of	be the host of or for .
put an end to , make invalid a process that 's already begun	make invalid for use .
enjoy , be fond of or approve	feel about or towards ; consider , evaluate , or regard .
per centum	a proportion in relation to a whole ( which is usually the amount per hundred ) .
an approximate attribute or quality of something	an approximate definition or example .
the act of having and controlling property .	the state or fact of being an owner .
a physical protuberance , large or small	a natural elevation ( especially a rocky one that juts out into the sea ) .
estimate or calculate the numerical value of something	evaluate or estimate the nature , quality , ability , extent , or significance of .
a portion or percentage of a whole	the part played by a person in bringing about a result .
lightest most abundant element , atomic number 1	a nonmetallic univalent element that is normally a colorless and odorless highly flammable diatomic gas ; the simplest and lightest and most abundant element in the universe .
a unit cost of something	a single chance or instance .
move back and forth	move or sway in a rising and falling or wavelike pattern .
a cyclical span of time defined by a calendar system	a period of time containing 365 ( or 366 ) days .
face an event and survive ; endure	face and withstand with courage .
( medicine ) the capacity of an organism to defend against disease .	( medicine ) the condition in which an organism can resist disease .
a statement , an idea expressed in language	a brief statement .
perform a duty	do duty or hold offices ; serve in a specific function .
soldier who is a member of a special forces group	a member of a military unit trained as shock troops for hit-and-run raids .
become master of , overcome , dominate	get on top of ; deal with successfully .
area of damaged , cut tissue on a living body	a casualty to military personnel resulting from combat .
revolve	change directions as if revolving on a pivot .
twice the quantity or amount of something	a quantity that is twice as great as another .
give an incentive for action , provoke or stir up , urge on , or cause to act .	provoke or stir up .
funeral direction	the trade of a funeral director .
to ignite or catch on fire	catch fire .
a large approximate quantity of some attribute or thing	a concentrated example of something .
medicines	a substance that is used as a medicine or narcotic .
a method for solving a problem	the successful action of solving a problem .
reach an objective , attain a benchmark or goal	develop in a positive way .
take something or someone away from somewhere	go away or leave .
a stiffener in a garment	( nautical ) brace consisting of a heavy rope or wire cable used as a support for a mast or spar .
a constructed underground passageway	a passageway through or under something , usually underground ( especially one for trains or cars ) .
discern , identify , or know because of a previous experience	be fully aware or cognizant of .
move or change one 's own position or quality	move very slightly .
incorporate or enclose one thing in another	incorporate a food ingredient into a mixture by repeatedly turning it over without stirring or beating .
guide , draw through	pass over , across , or through .
rescue , redeem , deliver from harm or danger	refrain from harming .
beat ( as if ) with a whip or rod	strike as if by whipping .
the medical procedure of manually turning the uterus	manual turning of a fetus in the uterus ( usually to aid delivery ) .
create an edge or border	enclose in or as if in a frame .
restart or continue an activity after an interruption or pause	take up or begin anew .
capture , ensnare , discover in the act	discover or come upon accidentally , suddenly , or unexpectedly ; catch somebody doing something or in a certain state .
initiation , founding , introduction of something	the act of starting something for the first time ; introducing something new .
a creased or bent form	an angular or rounded shape made by folding .
train , tutor or polish social behavior , taste , judgement	teach or refine to be discriminative in taste or judgment .
a mental activity of construing or interpreting	an interpretation of a text or action .
emphasize ; draw attention to ; underline	draw a line or lines underneath to call attention to .
possibility for the future	a prediction of the course of a disease .
require or need something that is missing	have need of .
an indication or manifestation of something , often physical	an indication of damage .
a sudden , brief burst of light	a momentary brightness .
come or bring back to life , health , existence or use	cause to regain consciousness .
a mental state of sadness .	a mental state characterized by a pessimistic sense of inadequacy and a despondent lack of activity .
position or location change	the act of changing the location of something .
( cause to ) move through a space , circuit or system , usu. returning to the starting point	move in circles .
bring in to consonance	bring ( several things ) into consonance or relate harmoniously .
submit , send to	cause to move ; cause to be in a certain position or condition .
state of being unified	the state of being joined or united or linked .
( cause to ) become different or aquire a different character , possibly during development .	become distinct and acquire a different character .
an objective or goal	the goal intended to be attained ( and which is believed to be attainable ) .
seize and take captive ; take or gain possession of something	take possession of by force , as after an invasion .
give , dedicate , pledge	give entirely to a specific person , activity , or cause .
decide a specific time for an event	make a schedule ; plan the time and place for events .
value a thing or course of action more highly than another	like better ; value more highly .
give something for a cause	give to a charity or good cause .
furnish with a guideline	furnish with rubrics or regulate by rubrics .
a social entreaty , as courtship or pleading	a petition or appeal made to a person of superior status or rank .
fail in strength or health and cease to funtion	break down , literally or metaphorically .
reply verbally or in written form to a question , comment , letter , or speech	react verbally .
a slight cut in a physical surface	a slight surface cut ( especially a notch that is made to keep a tally ) .
cause something to be the case	cause to move ; cause to be in a certain position or condition .
a state of confinement in a small space	the act of forcing yourself ( or being forced ) into or through a restricted space .
state or explain the meaning	give a definition for the meaning of a word .
cause animals to move	pursue for food or sport ( as of wild animals ) .
be against , resist	act against or in opposition to .
a quantity of money added to a bank account	money deposited in a bank or some similar institution .
cause to come into existence ; create	bring into being .
performance , routine	a short theatrical performance that is part of a longer program .
people assembled together in a rhythmic movement	a party of people assembled for dancing .
a computer server	( computer science ) a computer that provides client stations with access to files and printers as shared resources to a computer network .
forbid , prohibit	forbid the public distribution of ( a movie or a newspaper ) .
computer text files	( computer science ) a computer file that contains text ( and possibly formatting instructions ) using seven-bit ascii characters .
a speech act of acknowledging gratitude for something	an acknowledgment of appreciation .
a state of pretending to be someone , something else	an outward semblance that misrepresents the true nature of something .
become widespread as an idea or feeling .	cause to become widely known .
connect with ; reach a target or goal	perceive with the senses quickly , suddenly , or momentarily .
income collected as tax by a government	government income due to taxation .
be the deciding factor in a state of affairs or an outcome	shape or influence ; give direction to .
end	put an end to .
a region allocated to hold something	the particular portion of space occupied by something .
acknowledge a contribution or cause	have trust in ; trust in the truth or veracity of .
arrangement	logical or comprehensible arrangement of separate elements .
system of arrangement	an arrangement scheme .
close within bounds ; deprive of freedom	to close within bounds , limit or hold back from movement .
to collect , acquire or gather	get or gather together .
deliver a formal talk or reprimand at length	censure severely or angrily .
a pair of mated people , e.g. , married	a pair of people who live together .
rot ; become unfit for consumption	become unfit for consumption or use .
lock with one another	become engaged or intermeshed with one another .
take vows , join or allow to join a religious order	take vows , as in religious order .
activity of selling	the general activity of selling .
give out , allow to have	allow to have .
secondary public school , grades 9-12	a public secondary school usually including grades 9 through 12 .
benjamin rush , physician and american revolutionary leader .	physician and american revolutionary leader ; signer of the declaration of independence ( 1745-1813 ) .
luggage compartment of a car	british term for the luggage compartment in a car .
have a monopoly of ; control fully	have or exploit a monopoly of .
reduce to a simpler molecular compound	reduce ( petroleum ) to a simpler compound by cracking .
cause to be interested	attract ; cause to be enamored .
to remain emotionally or intellectually attached without necessary physical contact .	to remain emotionally or intellectually attached .
the act of transporting goods commerically at rates cheaper than express rates .	transporting goods commercially at rates cheaper than express rates .
( an occurance of ) the preservation or management of natural resources .	the preservation and careful management of the environment and of natural resources .
remove the pod , husk or shell	fall out of the pod or husk .
abstain from eating or from certain foods	abstain from eating .
feel hot or painful , as if burning	feel hot or painful .
( cause to ) return after being refused	come back after being refused .
a loss of function	loss of ability to function normally .
administrator , one who controls resources	someone who controls resources and expenditures .
a stovetop , cooking appliance	a kitchen appliance used for cooking food .
rinse one 's mouth with mouthwash , gargle	rinse one 's mouth and throat with mouthwash .
a quantity that is an approximate calculation	an approximate calculation of quantity or degree or worth .
turn on an axis ; spin	turn on or around an axis or a center .
marriage offer	an offer of marriage .
try to gain favor by flattering or showing submission or fear .	show submission or fear .
the public submission of a legal record	the entering of a legal document into the public record .
shrivel , wither , or mature imperfectly , as of a flower .	shrivel or wither or mature imperfectly .
have faith in , bet on	have faith or confidence in .
burst into flames ( telic )	start to burn or burst into flames .
the cognitive processes and capacity to remember .	the cognitive processes whereby past experience is remembered .
mechanism that controls the water level in a section of canal	enclosure consisting of a section of canal that can be closed to control the water level ; used to raise or lower vessels that pass through it .
an onerous worry or concern	an onerous or difficult concern .
someone or something that is the agent of fulfilling desired expectations	someone ( or something ) on which expectations are centered .
a sharp side of an object	a sharp side formed by the intersection of two surfaces of an object .
the forceful hit of a ball	hitting a golf ball off of a tee with a driver .
fine powdery material ; the remains of something destroyed or broken up .	the remains of something that has been destroyed or broken up .
throw with force	utter with force ; utter vehemently .
treat a substance with some agent ; add an agent to .	treat with an agent ; add ( an agent ) to .
pass through the esophagus	pass through the esophagus as part of eating or drinking .
move freely ( usually within a bounded space )	cause to move or operate freely within a bounded space .
secrete or form water	secrete or form water , as tears or saliva .
the state of being in contact	the state of being connected .
a variant of a musical theme which employs notes of reduced duration from the original theme	the statement of a theme in notes of lesser duration ( usually half the length of the original ) .
time to come	the time yet to come .
the legal state of owing money	the state of owing something ( especially money ) .
a style and size of typeset	a specific size and style of type within a type family .
demand , ask for , or take as one 's due	demand as being one 's due or property ; assert one 's right or title to .
cause to be distrusted or rejected ; damage the reputation of .	damage the reputation of .
give equal rights to , as of the right to vote .	give equal rights to ; of women and minorities .
( cause to ) lengthen or expand in time or some abstract realm	lengthen in time ; cause to be or last longer .
a knapsack , bundle on the back	a bundle ( especially one carried on the back ) .
a person who delivers information or goods	a person who conveys ( carries or transmits ) .
having an intuitive understanding or appreciation of something	an intuitive understanding of something .
adherence to moral principles	adhering to moral principles .
have sex with	have sexual intercourse with .
partake or provide a banquet	partake in a feast or banquet .
idolize / show devotion to	show devotion to ( a deity ) .
make a ticking sound	make a clicking or ticking sound .
run or flow slowly	run or flow slowly , as in drops or in an unsteady stream .
write a computer programme .	write a computer program .
a state of social order in conformance with existing law	a state of order in which events conform to the law .
an electronic storage device .	an electronic memory device .
a reference line used to align lettering	a light line that is used in lettering to help align the letters .
the quality of dedication , fixity of purpose	the trait of sincere and steadfast fixity of purpose .
look furtively at something .	look furtively .
cast off , get rid of something	get rid of .
recover posession or get back again	get or find back ; recover the use of .
a coefficient assigned to elements in a frequency distribution in order to indicate the relative importance of each element	( statistics ) a coefficient assigned to elements of a frequency distribution in order to represent their relative importance .
( cause to ) move around	cause to move round and round .
become due	become due for repayment .
provide medical care for .	provide veterinary care for .
do over , make new	make new .
coat , cover , or treat the surface of	put a coat on ; cover the surface of ; furnish with a surface .
baseball : strike out a batter	strike out ( a batter ) , ( of a pitcher ) .
regain or make up for , as of a financial loss .	regain or make up for .
duplicate , match	duplicate or match .
indistinct vocal articulations	indistinct articulation .
the act of shoving something away	the act of applying force in order to move something away .
move or drive forcefully as if by a punch .	drive forcibly as if by a punch .
an intense surprise , often unpleasant	an unpleasant or disappointing surprise .
make less emotionally hostile ; win over mentally or emotionally .	make less hostile ; win over .
informal usage for a domestic cat , often young	informal terms referring to a domestic cat .
the act of sorting one thing from others .	sorting one thing from others .
the act of physically affixing or connecting things	the act of fastening things together .
the people who dwell in a camp	a group of people living together in a camp .
an unforseen development .	an unforeseen development .
bring into general popular / common use	cater to popular taste to make popular and present to the general public ; bring into general or common use .
make impure ; make radioactive	make impure .
a long , thin implement , usually made of wood	an implement consisting of a length of wood .
formally reject or disavow a formerly held belief ; retract a statement .	formally reject or disavow a formerly held belief , usually under pressure .
( cause to ) to turn to the left side .	turn or go to the port or left side , of a ship .
entail as a necessary accompaniment or result	impose , involve , or imply as a necessary accompaniment or result .
physically attach to something .	fix to ; attach .
assign to a particular task	assign to a specific task .
culminating event	be the culminating event .
act of constructing	the act of constructing something .
the primary information-processing component of a computer , of a microprocessor chip	( computer science ) the part of a computer ( a microprocessor chip ) that does most of the data processing .
consider again , usually with a view to changing	consider again ( a bill ) that had been voted upon before , with a view to altering it .
cancel , reverse , annul	cancel , annul , or reverse an action or its effect .
define ; determine essential qualities of	determine the essential quality of .
the pursuit and killing or capture of animals .	the pursuit and killing or capture of wild animals regarded as a sport .
manipulate the registers of a musical instrument	manipulate the registers of an organ .
move in an irregular course	move to and fro or from place to place usually in an irregular course .
the legal granting or bestowment of rights	the act of granting rights .
jolt of electrical current to the body	a reflex response to the passage of electric current through the body .
become pregnant .	become pregnant ; undergo conception .
the bestowing of a franchise , enfranchisment	the act of certifying or bestowing a franchise on .
act of distributing	the act of apportioning or distributing something .
the state of being more than satisfied or satiated .	the state of being more than full .
conscious subjective emotion or desire	the conscious subjective aspect of feeling or emotion .
the act of proposing someone as a candidate for something .	the condition of having been proposed as a suitable candidate for appointment or election .
to hunt snipe	hunt or shoot snipe .
hunt for hawks	hunt with hawks .
a continuous horizontal layer of brick	( construction ) a layer of masonry .
a brief attempt at some endeavor	a usually brief attempt .
propagation of waves back from a surface	the phenomenon of a propagating wave ( light or sound ) being thrown back from a surface .
examine minutely ; search diligently	examine minutely .
enjoy , be fond of or approve	be fond of .
a person under the guardianship or custody of another	a person who is under the protection or in the custody of another .
strike or hit sharply , perhaps as in sport .	strike sharply , as in some sports .
fly in or on a glider plane	fly in or as if in a glider plane .
one fourth of a year	a fourth part of a year ; three months .
make an abstract thing tight or more restrictive	make tight or tighter .
provide ( a person or group ) with power or authority	provide with power and authority .
run at a moderately swift pace , as for exercise .	run at a moderately swift pace .
envelop completely ; form a cover over .	form an impenetrable cover over .
mold for casting , setting concrete	a mold for setting concrete .
cause friction ; wear away or erode	wear away or erode .
a feeling for something that is desired intensely .	something that is desired intensely .
put or store in a bottle	store ( liquids or gases ) in bottles .
be a sign or indication of ; have as a meaning .	be a sign or indication of .
the act of choosing , picking one among many	the act of choosing or selecting .
act of becoming distant , moving away from	the act of becoming more distant .
take in marriage ; perform a marriage ceremony	take in marriage .
skip , leap , or move up and down or sideways as a manner of motion .	skip , leap , or move up and down or sideways .
a military fortification , stronghold	a stronghold .
the fashionable elite of a given community	the fashionable elite .
characteristic call of an animal	the characteristic utterance of an animal .
make or become more acute or intense	make more intense , stronger , or more marked .
a journey for some purpose .	a journey for some purpose ( usually including the return ) .
fake or falsify ; control in a fraudulent manner .	manipulate in a fraudulent manner .
fruit cooked down with sugar , jam	fruit preserved by cooking with sugar .
the act of leading or guiding others	the activity of leading .
coating used as a repellant to moisture	a finishing coat applied to exclude moisture .
a person who cleans chimneys	someone who cleans soot from chimneys .
shine intensely ; emit a steady , even light from a source .	emit a steady even light without flames .
behave in a certain way ; have a specific effect or outcome	behave in a certain way .
communicate with a hiss	express or utter with a hiss .
a male bee whose function is to fertilize the queen	stingless male bee in a colony of social bees ( especially honeybees ) whose sole function is to mate with the queen .
a sporting match , boxing	a boxing or wrestling match .
cause to reproduce ( plants or animals )	cause to procreate ( animals ) .
the feeling of annoyance at being hindered or thwarted .	a feeling of annoyance at being hindered or criticized .
move along on wheels	move along on or as if on wheels or a wheeled vehicle .
[ provide with a new or different resting place	provide with a new seat .
activity of extracting ore or other matter from the ground	the act of extracting ores or coal etc from the earth .
to interrupt , enter uninvited	enter uninvited .
a person or thing equal to another in value or significane .	a person or thing equal to another in value or measure or force or effect or significance etc .
a cause or source of harm	a cause of pain or injury or loss .
make ( more ) comprehensible	make clear and ( more ) comprehensible .
the state of being retained	the act of retaining something .
a problem , something wrong	a problem .
stretch out or over completely	stretch out completely .
continue to live , exist , or prosper	continue to live through hardship or adversity .
a caress with the lips	the act of caressing with the lips ( or an instance thereof ) .
provide with rails , as by laying .	lay with rails .
the close approach of one object to another	the motion of one object relative to another .
make a hole with a pointed tool	make a hole , especially with a pointed power or hand tool .
fix ( something old ) with a new part ; improve .	piece ( something old ) with a new part .
the act of damaging something , causing breakage	the act of breaking something .
the ground level of a multi-storied building	the floor of a building that is at or nearest to the level of the ground around the building .
a quantity of something	a quantity of money .
a large room	the large room of a manor or castle .
leave out , omit , prevent from entering	prevent from entering ; keep out .
sniff at inquiringly .	sniff or smell inquiringly .
provide lodging for	provide housing for .
change the purpose or functioning of a system .	change the inherent purpose or function of something .
provide with tools or items for a specific purpose	provide with ( something ) usually for a specific purpose .
gain points in a game ; add up ( numbers )	gain points in a game .
travel in front of , be first , precede	travel in front of ; go in advance of others .
remove by rubbing	remove by or as if by rubbing or erasing .
the hard upper part of the human nose	the hard ridge that forms the upper part of the nose .
make shine	make ( a surface ) shine .
recover , return to former state	return to a former condition .
remove the pod , husk or shell	remove the husks from .
speed up the process of	speed up the progress of ; facilitate .
( cause to ) swing and miss the third pitch , striking out	strike out by swinging and missing the pitch charged as the third .
literally and quantifiably raise in social rank or status .	raise in rank , character , or status .
alter by chemical means , to make images .	make visible by means of chemical solutions .
highly infectious viral disease	an acute febrile highly contagious viral disease .
make a certain size or sort according to size	make to a size ; bring to a suitable size .
remove tree stumps from an area .	remove tree stumps from .
pass the tongue over , take up with the tongue	pass the tongue over .
a computer-generated visual image	an image that is generated by a computer .
do better in a competition ; win	come out better in a competition , race , or conflict .
aerodynamic force that opposed gravity	the component of the aerodynamic forces acting on an airfoil that opposes gravity .
start abruptly , ignite	start abruptly .
a local announcement made within a public broadcast	( broadcasting ) a local announcement inserted into a network program .
making real or concrete	something that is made real or concrete .
sound sharply or shrilly , as if stabbing .	sound sharply or shrilly .
the act of officially gaining entrance to somewhere	the act of admitting someone to enter .
spend time in prison	spend time in prison or in a labor camp .
hold , contain within	contain or hold ; have within .
act of verbally informing	the act of informing by verbal report .
forcefully request	request urgently and forcefully .
the quality of dissimilarity	the quality of being unlike or dissimilar .
throw quickly , flick	throw quickly .
move to and fro around a particular point or points , remain near	move to and fro .
put up with something or someone unpleasant ; show deference towards someone or some authority .	put up with something or somebody unpleasant .
the breakup or termination of a social relationship	the termination or disintegration of a relationship ( between persons or nations ) .
destruction of a ship	destroy a ship .
the human act of making something new .	the act of starting something for the first time ; introducing something new .
ride ( a bicycle or motorcycle )	ride a motorcycle .
the principal activity that one does to earn money .	the principal activity in your life that you do to earn money .
maintain or preserve a particular condition , state , or activity	continue a certain state , condition , or activity .
a spoken or written reply to a question	a statement ( either spoken or written ) that is made to reply to a question or request or criticism or accusation .
committee with supervisory powers	a committee having supervisory powers .
a section of a composition , textual or musical	a short section of a musical composition .
a gear for changing the motion of a machine to the opposite direction	the gears by which the motion of a machine can be reversed .
take a digestion-aiding walk after a meal	take a walk for one 's health or to aid digestion , as after a meal .
forked form or shape	a part of a forked or branching shape .
insert or close with a plug	fill or close tightly with or as if with a plug .
incite some act of insubordination	incite , move , or persuade to some act of lawlessness or insubordination .
formally announce the termination of an agreement	announce the termination of , as of treaties .
beat or pound rapidly	cause to throb or beat rapidly .
make a line or marks on a surface ; copy by following the lines of	make a mark or lines on a surface .
recite as a chant , intone	recite with musical intonation ; recite as a chant or a psalm .
the ability of computers to exchange digital information between them and make use of it	( computer science ) the ability to exchange and use information ( usually in a large heterogeneous network made up of several local area networks ) .
act of applying force	the act of applying force suddenly .
the process of becoming less or smaller	a process of becoming smaller or shorter .
be in command of ; exercise authority or control over .	exercise authoritative control or power over .
be a factor or play a role in something	be or play a part of or in .
an expanse of land	an extended area of land .
move an implement through with a circular motion , mix	move an implement through .
deprive of courage , hope , or optimism	deprive of courage or hope ; take away hope from ; cause to feel discouraged .
the armed forces	a force that is a branch of the armed forces .
furnish with metal spurs .	furnish with spars .
remove water from a substance .	remove water from .
provide with rails , as by laying .	provide with rails .
make or be a summary	be a summary of .
be affected with smut or mildew	affect with smut or mildew , as of a crop such as corn .
talk or behave amorously ; have sex with .	talk or behave amorously , without serious intentions .
excuse some minor social infraction ; accept an excuse for something .	accept an excuse for .
indicate , be signs or symptoms of	be a signal for or a symptom of .
a verbal or written request for access to something .	a verbal or written request for assistance or employment or admission to a school .
have a logical result	have as a logical consequence .
travel on foot .	cross on foot .
the act of suction	the act of sucking .
a band of leather or rope made to identify animals .	a band of leather or rope that is placed around an animal 's neck as a harness or to identify it .
put a harness on .	put a harness .
provide or equip specifically with furniture .	provide or equip with furniture .
to move ( the head or body ) quickly downwards or away ( from something ) .	to move ( the head or body ) quickly downwards or away .
reason or establish by deduction	reason by deduction ; establish by deduction .
make pregnant ; fertilize and cause to grow .	fertilize and cause to grow .
find the solution to or understand the meaning of	find the solution to ( a problem or question ) or understand the meaning of .
move about in a confused or purposeless manner .	move about in a confused manner .
put up with something unpleasant	put up with something or somebody unpleasant .
a means or agency by which something is communicated .	a means or agency by which something is expressed or communicated .
take apart into constituent pieces	take apart into its constituent pieces .
a short theatrical program that is part of a longer program .	a short theatrical performance that is part of a longer program .
decree , issue an order	issue an order .
the termination , ending of a meeting	the termination of a meeting .
an indicator that orients one generally .	an indicator that orients you generally .
increase the acoustic volume of .	increase the volume of .
open to members of all races and ethnic groups	open ( a place ) to members of all races and ethnic groups .
reduce to small pieces by pounding or abrading	reduce to small pieces or particles by pounding or abrading .
hit a fly ( baseball )	hit a fly .
fishing-exhaust by allowing to pull on the line	exhaust by allowing to pull on the line .
be or come into conflict	be incompatible ; be or come into conflict .
produce a phonemic click .	produce a click .
angle with a hook and line and draw through water	angle with a hook and line drawn through the water .
the front face of a building	the face or front of a building .
make something more diverse or varied	make something more diverse and varied .
issue bonds on something	issue bonds on .
women 's sleeveless undergarment	a woman 's sleeveless undergarment .
move oneself very fast .	move very fast .
oppose or approach , as in hostility or competition	oppose , as in hostility or a competition .
make more complex or intricate	make more complex , intricate , or richer .
cause to be / show to be invalid	show to be invalid .
create a new entity by putting components or members together	create by putting components or members together .
the activity of providing supplies	the activity of supplying or providing something .
make or become brighter or lighter	make lighter or brighter .
actors in a play	the actors in a play .
take someone 's soul into heaven	take up someone 's soul into heaven .
discipline in personal or social activities .	discipline in personal and social activities .
a person eating a meal , often in a restaurant	a person eating a meal ( especially in a restaurant ) .
a sudden ( emotional ) outburst .	a sudden outburst .
make or become harder	make hard or harder .
the introductory portion of a story	the introductory section of a story .
work material with a tool	work with a tool .
make or become less strict or severe	make less severe or strict .
support by placing on or against something solid	support by placing against something solid or rigid .
part , cease , or break association with ( something ) .	part ; cease or break association with .
have the financial means to obtain , buy , or do something	have the financial means to do something or buy something .
a list of candidates nominated by a political party to run for election .	a list of candidates nominated by a political party to run for election to public offices .
say , state , or perform again	to say , state , or perform again .
allow the passage of air	allow the passage of air through .
unite ; merge with something already in existence	unite or merge with something already in existence .
use resources or materials	use up ( resources or materials ) .
make or become harder	become hard or harder .
( cause to ) be firmly attached or closed .	cause to be firmly attached .
make or become wider or more extensive	become broader or wider or more extensive .
unrestricted freedom to use something .	unrestricted freedom to use .
laying claim , the act of taking possession of , or power over , something .	the act of taking possession of or power over something .
give structure to	give a structure to .
mark with scars	mark with a scar .
( baseball ) tag the base runner to get him out .	tag the base runner to get him out .
be reflected as heat , light , or shock waves ; .	be reflected as heat , sound , or light or shock waves .
a competitor most likely to win	a competitor thought likely to win .
make or become longer	become long or longer .
be on base at the end of an inning	to be on base at the end of an inning , of a player .
either of the two categories ( male or female ) into which most organisms are divided , or key properties that distinguish the categories .	either of the two categories ( male or female ) into which most organisms are divided .
( science ) the atomic weight of an element that has the same combining capacity as a given weight of another element .	the atomic weight of an element that has the same combining capacity as a given weight of another element ; the standard is 8 for oxygen .
provide with a toggle	provide with a toggle or toggles .
( cause to ) move back and forth or side to side	cause to move back and forth .
measure the depth of a body of water	measure the depth of ( a body of water ) with a sounding line .
make a loud noise , as an animal	make a loud noise , as of animal .
the act of coming to rest after a voyage .	the act of coming to land after a voyage .
join or bring together ( two ) objects , ideas , or people	bring two objects , ideas , or people together .
make reference to something .	make reference to .
behave violently , as if in a state of great anger ; break or tear violently .	behave violently , as if in state of a great anger .
form a spiral or move in a spiral course .	move in a spiral or zigzag course .
a feeling of aversion , distaste , antipathy	a feeling of aversion or antipathy .
release ( gas or energy ) as a result of a chemical reaction or physical decomposition ( perhaps in a metaphorical sense )	release ( gas or energy ) as a result of a chemical reaction or physical decomposition .
overcome with amazement ; flabbergast	overcome with amazement .
behave in a condescending manner	behave in a patronizing and condescending manner .
take into one 's family or group	take into one 's family .
( contract bridge ) the highest bid becomes the contract setting in the number of tricks that the bidder must make .	( contract bridge ) the highest bid becomes the contract setting the number of tricks that the bidder must make .
go on a campaign or off to war	go on a campaign ; go off to war .
react , or respond to a call , command , or stimulus	react to a stimulus or command .
( literally ) sound with resonance .	sound with resonance .
an injury to the skin caused by radiation , heat or chemicals	an injury caused by exposure to heat or chemicals or radiation .
make a causal or logical connection ; group together	make a logical or causal connection .
apply conditioner to make smooth and shiny .	apply conditioner to in order to make smooth and shiny .
exercise or have power of memory	exercise , or have the power of , memory .
a feeling or state of extreme anger .	a state of extreme anger .
wrinkled , crumpled , or creased .	become wrinkled or crumpled or creased .
admit to testing / proof	admit to testing or proof .
an accounting period of 12 months	any accounting period of 12 months .
praise the qualities in order to sell or promote	make a plug for ; praise the qualities or in order to sell or promote .
relative darkness of a color	relative darkness or lightness of a color .
strike heavily , especially with a fist or implement .	strike heavily , especially with the fist or a bat .
make receptive or willing toward an action or belief .	make receptive or willing towards an action or attitude or belief .
open again , open anew	open again or anew .
a conceptual formulation ; a way of conceiving something .	a way of conceiving something .
heat metal prior to working it	heat a metal prior to working it .
feel the strong need to eat	feel the need to eat .
be in direct physical contact with	be in direct physical contact with ; make contact .
give suck to ; receive suck .	give suck to .
covering for a bed	decorative cover for a bed .
grip , penetrate or tear off with or as if with the teeth or jaws	to grip , cut off , or tear with or as if with the teeth or jaws .
play a stringed instrument with a bow	play on a string instrument with a bow .
doubt or an impression that something might not be the case .	an impression that something might be the case .
a successful throw or try for a point after a touchdown .	a successful free throw or try for point after a touchdown .
express audibly ; utter sounds ( not necessarily words ) ; indicate .	express audibly ; utter sounds ( not necessarily words ) .
hold back in uncertainty or unwillingness	pause or hold back in uncertainty or unwillingness .
a serving of a beverage	a single serving of a beverage .
give an incentive or reason for action .	give an incentive for action .
the day before today	the day immediately before today .
take or capture by force or authority	take or capture by force .
( medicine ) apply a plaster cast to .	apply a plaster cast to .
interfere with someone else 's activity	interfere in someone else 's activity .
assign a new time for an event	assign a new time and place for an event .
value measured by what must be given or done to obtain something .	value measured by what must be given or done or undergone to obtain something .
touch or hold with the hands	touch , lift , or hold with the hands .
scrape or rub to relieve itching	scrape or rub as if to relieve itching .
give a detailed account of	narrate or give a detailed account of .
any activity that acquires a person 's attention .	any activity that occupies a person 's attention .
cause to become awake or alert	cause to become awake or conscious .
provide a feast or banquet	provide a feast or banquet for .
the act of hindering someone 's plans or efforts .	an act of hindering someone 's plans or efforts .
fool or hoax ( someone ) .	fool or hoax .
raising the stakes or bet of a game by a factor of 2	raising the stakes in a card game by a factor of 2 .
the ( period of ) control of a country by military forces of a foreign power .	the control of a country by military forces of a foreign power .
( computer science ) the occurence of an incorrect result produced by a computer .	( computer science ) the occurrence of an incorrect result produced by a computer .
give pleasure , satifaction , or happiness ; be pleasing to	give pleasure to or be pleasing to .
the soft padding under a saddle	a soft pad placed under a saddle .
elecate or idealize in allusion to christ 's transfiguration	elevate or idealize , in allusion to christ 's transfiguration .
inability of the heart to pump blood to sustain life functions	inability of the heart to pump enough blood to sustain normal bodily functions .
cause to vibrate in a different pattern	cause to vibrate in a definite pattern .
warn or call to a sense of preparedness	warn or arouse to a sense of danger or call to a state of preparedness .
adapt oneself to new or different conditions .	adapt or conform oneself to new or different conditions .
move faster , or cause to move faster	cause to move faster .
supply food ready to eat , as for parties and banquets .	supply food ready to eat ; for parties and banquets .
express protest or dissent , raise an objection	express or raise an objection or protest or criticism or express dissent .
clear mucus from one 's throat	clear mucus or food from one 's throat .
pass into a state or condition	pass into a specified state or condition .
add embellishments ( to medieval manuscripts )	add embellishments and paintings to ( medieval manuscripts ) .
make or become thick	make thick or thicker .
move or execute very quickly or hastily	run or move very quickly or hastily .
hurt , feel physical pain	feel physical pain .
tell or spread rumors ; say	tell or spread rumors .
throw with force or recklessness ; cast away	throw with force or recklessness .
return to in thought or speech	return in thought or speech to something .
try to cure by special care or treatment , of an illness or injury ; treat carefully .	try to cure by special care of treatment , of an illness or injury .
a sweeping cut with a sharp instrument	a strong sweeping cut made with a sharp instrument .
any address at which one dwells more than temporarily .	any address at which you dwell more than temporarily .
botany -- the usually underground organ of a plant that lacks buds or leaves or nodes , which absorbs water and mineral salts ; usually it anchors the plant to the ground .	( botany ) the usually underground organ that lacks buds or leaves or nodes ; absorbs water and mineral salts ; usually it anchors the plant to the ground .
reproduce or make an exact copy of ; make , do , or perform again .	reproduce or make an exact copy of .
pass ( a thread ) through or into , on or as if on a string	thread on or as if on a string .
engrave by means of dots .	engrave by means of dots and flicks .
have a strong desire to do something	have a strong desire or urge to do something .
be relevant or pertinent	be pertinent or relevant or applicable .
indicate contempt by breathing noisily and forcefully through the news	indicate contempt by breathing noisily and forcefully through the nose .
become aware of through the senses	to become aware of through the senses .
cause to be alert or energetic	cause to be alert and energetic .
remove by erasing or crossing out , as if by drawing a line through .	remove by erasing or crossing out or as if by drawing a line .
cook slowly for a long time in liquid	cook slowly and for a long time in liquid .
the temperature at which a liquid boils , bubbles	the temperature at which a liquid boils at sea level .
make a map of ; show or establish the features or details of ; explore or survey for the purposes of making a map .	make a map of ; show or establish the features of details of .
the social force that binds one to the courses of action demanded by that force .	the social force that binds you to the courses of action demanded by that force .
avoid or try to avoid fulfilling , answering , or performing .	avoid or try to avoid fulfilling , answering , or performing ( duties , questions , or issues ) .
lead someone in the wrong direction ( physically ) ; give wrong spatial directions .	lead someone in the wrong direction or give someone wrong directions .
maintain , assert , or claim	maintain or assert .
improve by restoring to a previous or better condition .	restore to a previous or better condition .
make accessible to some action , influence , or condition	expose or make accessible to some action or influence .
approach a limit as the number of terms increases without limit ; specifically a mathematical term .	approach a limit as the number of terms increases without limit .
the stiching that forms the rim of a shoe or boot .	the stitching that forms the rim of a shoe or boot .
put under the control of the federal government	put under the control and authority of a federal government .
manual stimulation fo the genital area for sexual pleasure .	manual stimulation of the genital area for sexual pleasure .
equip with a fuse	equip with a fuse ; provide with a fuse .
end of the american revolution	the successful ending of the american revolution .
( mathematics ) the smallest whole number or a numeral representing this number .	the smallest whole number or a numeral representing this number .
stimulating or demanding factors of a situation	a demanding or stimulating situation .
a physical portion of all or part of a natural object that is collected and preserved as an example of its class or total .	all or part of a natural object that is collected and preserved as an example of its class .
amplify an electron current by causing part of the power on the output circuit to act upon the input circuit .	amplify ( an electron current ) by causing part of the power in the output circuit to act upon the input circuit .
a human utters words loudly and forcefully .	utter words loudly and forcefully .
oppose with equal weight or force	contrast with equal weight or force .
( cause to ) strike the air in flight .	strike the air in flight .
preserve in a tin or jar .	preserve in a can or tin .
a chain of atoms in a molecule forming a closed loop	( chemistry ) a chain of atoms in a molecule that forms a closed loop .
make the surface level or smooth	make the surface of level or smooth .
impress or affect deeply ( emotionally ) .	impress or affect deeply .
supply with a constant flow of some liquid , for the purpose of cooling , cleansing , or disinfecting .	supply with a constant flow or sprinkling of some liquid , for the purpose of cooling , cleansing , or disinfecting .
apply a thin coating of paint / metal	apply a thin coating of paint , metal , etc . , to .
disregard , fail to attend to	fail to attend to .
make a short , sharp sound	make a sharp sound .
connect or fasten into a chain by linking	connect or arrange into a chain by linking .
beat thoroughly in a competition or fight	beat thoroughly and conclusively in a competition or fight .
look through a book or some other written material ( for information ) .	look through a book or other written material .
state of being active	the state of being active .
( theology ) the act of deliving from sin or saving from evil .	( theology ) the act of delivering from sin or saving from evil .
declare or make unfit or unsuitable	make unfit or unsuitable .
cook on a hot surface using fat ; cook in oil .	cook on a hot surface using fat .
improve by pruning or polishing	improve or perfect by pruning or polishing .
an area that is central within some larger region .	an area that is approximately central within some larger region .
start suddenly , as if from fright	start suddenly , as from fright .
be larger in number , quantity , power , status , or importance , without personally having sovereign power .	be larger in number , quantity , power , status or importance .
give oneself entirely to a specific person , activity , or cause .	give entirely to a specific person , activity , or cause .
the finger next to the thumb , forefinger	the finger next to the thumb .
put up with something or someone ( unpleasant )	put up with something or somebody unpleasant .
role or function of the head of a government department	the role of the head of a government department .
consider again , usually with a view to changing	consider again ; give new consideration to ; usually with a view to changing .
drive at an excessive or illegal velocity	travel at an excessive or illegal velocity .
an air force military unit , smaller than a squadron	an air force unit smaller than a squadron .
the act of giving someone a job , hiring someone	the act of giving someone a job .
the act of annoying someone or something	the act of troubling or annoying someone .
droop , sink , or settle from or as if from pressure or loss of tautness ; become less intense .	droop , sink , or settle from or as if from pressure or loss of tautness .
cite as an authority ; resort to ( as in an argument ) .	cite as an authority ; resort to .
allocate or dedicate ; set aside or apart for a specific purpose or use .	set aside or apart for a specific purpose or use .
make out of components ( in an improvising manner )	make out of components ( often in an improvising manner ) .
rehearse , learn by repetition	learn by repetition .
intend something to move toward a certain goal	intend ( something ) to move towards a certain goal .
register formally as a participant	register formally as a participant or member .
write as if with print , not in cursive	write as if with print ; not cursive .
shoot down birds	shoot down , of birds .
appoint to clerical posts	appoint to a clerical posts .
( chemistry ) undergo sequestration by forming a stable compound with an ion .	undergo sequestration by forming a stable compound with an ion .
furnish with an opening to allow air to circulate or gase to escape .	furnish with an opening to allow air to circulate or gas to escape .
stand with arms or forelegs raised , as of menacing .	stand with arms or forelegs raised , as if menacing .
accounting period of 12 months	any accounting period of 12 months .
convert the genetic information in a strand of dna into a strand of rna .	convert the genetic information in ( a strand of dna ) into a strand of rna , especially messenger rna .
give a thrashing to , beat	give a thrashing to ; beat hard .
immerse or be immersed in a boiling liquid , for purposes of cooking or processing .	immerse or be immersed in a boiling liquid , often for cooking purposes .
supply with water for crops , as with channels , ditches , or streams .	supply with water , as with channels or ditches or streams .
the period of time during which a leasing contract is in effect .	the period of time during which a contract conveying property to a person is in effect .
protect or strengthen with sandbags .	protect or strengthen with sandbags ; stop up .
travel ; make a tour of a place	make a tour of a certain place .
the political head of city government	the head of a city government .
pass the tongue over , take up with the tongue	take up with the tongue .
a city on the river thames in bershire , southern england	a city on the river thames in berkshire in southern england .
a chart or map showing the dimensions , movements or progress of something	a chart or map showing the movements or progress of an object .
take away a vital or essential part of something .	take away a vital or essential part of .
an imperfection ; the quality of being inadequate or falling short .	the quality of being inadequate or falling short of perfection .
pat or squeeze , especially under the chin .	pat or squeeze fondly or playfully , especially under the chin .
make up something fictional or untrue	make up something artificial or untrue .
the act of swallowing liquid	the act of swallowing .
have unlawful sex with a prostitute	have unlawful sex with a whore .
reverse the winding or twisting of ; separate the tangles of .	reverse the winding or twisting of .
reimburse or compensate ( someone ) , as for a loss or sacrifice .	reimburse or compensate ( someone ) , as for a loss .
sharpen a razor with a strap	sharpen with a strap .
the longer telegraphic signal of morse code	the longer of the two telegraphic signals used in morse code .
the part of the body between the neck and upper arm , or any of its subparts .	the part of the body between the neck and the upper arm .
rain , hail , or snow hard and be very windy , often with thunder and lightning ; blow hard .	rain , hail , or snow hard and be very windy , often with thunder or lightning .
fill with high spirits	fill with high spirits ; fill with optimism .
the release of pressure built up during a stop consonant .	the terminal forced release of pressure built up during the occlusive phase of a stop consonant .
( cause to ) fall in drops	let or cause to fall in drops .
the status of being champion .	the status of being a champion .
draw advantages from ; take advantage .	draw advantages from .
