small dog chews on a big stick .	a dog shews on a big stick .
a tennis player hitting the ball .	two boys splashing in the surf .
a lone snowboarder in the middle of a snowy gust	a snowboarder is throwing up snow as he rides his board .
a pair of dogs playing with a purple ball .	two dogs play with purple football .
a bird lands in the water .	a boat floats in the water .
a group of young men sing out together .	a group of young women stand together .
a group of men play rugby .	a group of men are playing ball together .
three children stand on or near a fence .	the three children are standing on and by a fence .
a black dog emerges from the water with a white ball in its mouth .	a black dog walking out of the water with a white ball in his mouth .
two dogs ankle-deep in water .	two brown dogs play in the water .
a boat floats in the water .	a boat in the water .
a girl in a purple shirt and pink headband posing	a young girl wearing a hat and blue jeans is on a swing .
brown and white dog with baseball in mouth , field and building .	brown and white dog with a baseball in its mouth .
a brown dog digging a hole in front of a plant	a group of people walking on the side of a railroad track .
a brown and white dog is running through an uncut field that has mushrooms .	brown and white dog running through a grassy field .
the brown and white dog swims in a swimming pool .	a brown and white dog swims in a backyard swimming pool .
two gray dogs run together over the green grass .	two grey dogs running in green grass .
a boy in a red sled is riding down the hill .	a multicolour dog in a red collar crouching on the grass .
a dog has run into the water to catch a ball in his mouth .	a dog running through water with a ball in its mouth
the dogs are running through the water	the dog runs through the snow .
a white and brown dog rolls on it 's back in the sand .	a dog lying on its back in the sand .
a dog runs through the grass .	two dogs running through the grass .
two dogs play in the grass .	two dogs playing in the snow .
a black and brown dog runs through the woods .	a dog running through the woods .
brown and white dog playing in the grass .	black and white dog leaping for frisbee .
the two dogs are running on the grass .	two dogs are playing in the grass .
two dogs are running in a grassy field	two dogs running through a grassy field .
the couple is sitting near the water in lawn chairs .	the boy hops from one picnic table to the other in the park .
an american footballer is wearing a red and white strip .	a man wearing a red football uniform and gray gloves looks to the left .
three people sit at a picnic table outside of a building painted like a union jack .	three people sit at an outdoor table in front of a building painted like the union jack .
a group of people standing on a balcony in a very modern setting .	a group of people standing on a small balcony of a large building
a white dog sniffing sheep through a fence .	white fluffy dog kissing sheep through a fence .
a young girl holds up a peace sign .	a little girl holds onto a pole on a city street .
a man is hanging by a line off a cliff above water .	man sitting by himself on a pier with a bottle of water .
a man crouching and holding a camera .	the crouching man is holding a large camera .
two dogs run through mud .	two dogs run through the snow .
man riding a bicycle down a narrow path .	a man riding a unicycle down a paved road
a man wearing an orange coat speaks to another as they walk in the snow .	a man and woman dressedin old fashion clothing sit outside at a table .
a dog swims through the water .	a dog wearing a cape is running through the snow .
a brown and white dog running on grass .	a brown and white dog running fast in a fenced yard .
german shephard jumping through black hoop while people watch	a dog jumps through a hoop .
a young girl wearing a blue leotard jumps in the air .	a young girl is in mid-air doing gymnastics .
a dog is jumping up in the air to catch a toy .	a black dog jumps in the air to catch a toy .
a young laughing girl and a boy are playing on a big drum .	a baby girl and little boy are standing next to a guitar and a drum .
a young boy with a purple mohawk playing the violin .	a boy with a blue mohawk plays the violin .
a brown dog laying on a blue cover .	a person is diving into clear blue water .
the two boys play in the field .	the two people have their heads covered with scarves .
the brown dog runs on the snow with a white ball in his mouth .	four dogs play in the snow with the city skyline behind them .
a black and white dog jumping over a red and white bar .	a dog is jumping over a red and white bar .
a woman in a green coat is standing near a pay phone .	a woman in a coat reclines next to a payphone .
a group of people standing in the street	a woman addressing a diverse group of people standing in the street .
a young girl in a helmet riding a skateboard down a sidewalk .	a little boy in a helmet is doing tricks on a skateboard .
two dogs are playing on a hardscape .	two dogs are playing on the grass .
people and camels at a beach .	people walking down a sidewalk on a beach .
a dog runs on brown grass .	a wet dog runs through the yellow grass holding a tennis ball .
a man is rock climbing on a natural rock .	a woman with glowing shoes at an outdoor event .
a group of men in suits are standing in front of a statue of a lion .	men standing in front of a statue of a lion .
a brown dog is running in the snow with a smaller black dog running behind it .	a large brown dog and small black dog walk on the snow .
a black and white dog running in a snowy park .	a black and white dog is jumping in the snow at a park .
the two dogs are running through the grass .	three dogs run in the snow .
two dogs running through sand .	three dogs running through a field .
the man and two young boys jump on a trampoline .	a man and two boys jump on a trampoline .
a man eating an apple , sitting in public .	a man sits in a public place eating an apple .
a boy with a broken arm is resting in a bed .	a boy with a broken arm is sleeping .
a black dog holds a tire and a ball in his mouth as another follows him .	a born dog carries some fruit in his mouth while two other dogs follow him .
a black dog bounds through a path in the snow .	two kids and a dog play in the snow .
boy doing tricks on a skateboard	a boy does a trick on a skateboard .
four boys sit in the mud .	four boys are sitting in a muddy stream .
two young girls hug each other in the grass .	two young girls holding each other on the grassy ground
two white dogs are walking through deep white snow .	two white dogs walk through a huge bank of mountain snow .
four girls in swimsuits are playing volleyball at the beach .	four women in bikinis are playing volleyball on the beach .
a bird flies across the water .	a bird flies above the water .
three dogs running in a field of grass .	two dogs run in a field of tall grass .
a dog is running through a pond	a pale dog is running along a dirt path .
two dogs are playing in a fenced in yard .	three dogs playing in the snow .
the brown and black dog is over top of the white dog .	the big brown and black dog is on top of a small white dog .
a boy jump kicks off a dock into a lake .	a little boy jumping off of a dock into a lake .
three dogs playing in the snow .	three dogs are playing in the water .
a little girl with a ribbon in her hair is picking her nose .	a little girl in a purple shirt and helmet is riding on a scooter .
a brown dog is running on a rock .	a brown dog running .
a boy wearing sunglasses looks straight ahead .	a young boy wearing glasses has his hair set to stand up .
a group of people white water rafting in a blue raft .	a group of people paddle their blue inflatable raft down the rapids .
a woman skiing down a snowy hill .	a person skis down a snowy hill .
a man and a woman watch two dogs .	a man in a maroon bathing suit swings on a rope on a lake .
a man sits by a dock looking at the water .	a man jumps off a rock into the water
a young girl going down a tube slide .	a young girl swinging off a tire swing
a large black dog runs along the green grass .	a gray dog runs along the green grass .
a boy hanging from a jungle gym	a boy swings on a jungle gym .
girls dressed in red and black costumes hold a wrestling pose .	two girls dressed like waitresses dance along with a man dressed as a chef .
many people are in the bicycle racing , including one man in a three-wheeled bike .	a man riding on a three-wheeled wheelchair .
a dalmation is running along the beach .	a white dog is running on sand .
a young girl wearing glasses and an orange t-shirt blows a large clear bubble .	the young girl blows a huge bubble .
two men are standing in front of a snow-capped mountain .	two men pose on a rocky area in front of a snowy mountain .
a group of people are wearing bunny ears .	a group of people ride in a race
a man in a red shirt takes a picture of girls wearing dresses and feathers .	a man takes a picture of his friend with performers .
a man and a woman pose in the snow with four children .	a man and a woman pose for the camera with pursed lips .
a dog in a " superman " shirt sleeps on a blanket .	a brown dog in a superman shirt is laying on a blue blanket .
a brown and white dog is running through the snow .	a brown and white dog is running on the grass .
man wearing a beret riding a bicycle	a man in a beret rides a bicycle down the street .
a tan dog is pulling a red sled in the snow .	a dog is pulling a red sled across the snow .
a black dog running with a black and white toy in it 's mouth .	a black dog flies through the air while holding an object in its mouth .
the white and brown dog runs across the grass .	a brown and white dog runs across the grass .
a baby reaching into a water fountain .	a baby trying to catch water from a fountain in his mouth
two black dogs run through a field .	two spotted dogs are running through a field
a man and a woman are standing in front of a building	two girls are sitting on an atv on the sand in front of a bridge .
a black dog is chasing after a red frisbee .	black dog chasing an orange frisbee .
a young girl , in an orange dress , holding a tennis racket .	a girl in a dress holds a tennis racket .
a smiling baby is sitting in a large plastic tub of water .	a baby is taking a bath in a bowl full of water .
a brown dog is resting its paws on a laptop keyboard .	a dog sits with its paws on a laptop computer .
a young girl with glasses sits and holds two american flags .	a girl in glasses is looking over two american flags near a wooded area .
a small white and brown dog is jumping over a horizontal pole .	a brown and white dog jumping over a red and yellow pole
a young boy leaps from one couch to another .	a young boy is leaping from one chair to another .
two little white dogs are playing in the snow .	two little orange and white dogs are in the snow .
a black dog and a brown dog run along a dirt path .	a black dog and a brown and white dog running and playing .
a child rides a wooden horse .	the child is on a wooden rocking horse .
a black and white dog running through some red and white poles	the white dog is running through a white posts on an obstacle course .
a dog jumps on a lawn .	a dog jumps of a surfboard
two bull dogs playing on the floor .	two dogs playing on carpet .
two dogs are running through a grassy area .	two dogs running through a grassy field .
kids playing ball in the park .	two dogs playing by the shore .
a man with an arm cast films something on video while another man is looking at the camera .	a man with a cast films some video while another man smiles .
baby with blonde pigtails in yellow room attempting to climb out of green playpen .	a female toddler in pigtails is trying to climb out of a green and white playpen .
a white dog looks at a black puppy in the snow .	a big white dog and a small black dog sit in the snow .
a man is swinging on a rope above the water .	a man in warm clothes swinging on monkey bars at night .
a man in a dress suit is riding a bike down the paved road .	a man is using a large pole to remove letters from a sign .
two asian men and asian woman sit in black massage chairs .	two asian men and a woman are relaxing in massage chairs .
a black and white dog is running in a grassy garden surrounded by a white fence .	a black and white dog is jumping over a hurdle .
an old man is sleeping at a table in front of a book shelf .	an older , balding man falling asleep on a chair in front of bookshelves .
the group of hikers is resting in front of a mountain .	several hikers rest with their gear in front of a mountain .
a girl playing is a pile of colorful balls .	a little girl plays in a pit of colorful balls .
a woman does a handstand on the beach .	a blond girl doing a handstand on a beach
a golden retriever is jumping off a wooden porch	a gold dog jumping off a wooden porch .
man stands next to woman dressed up as a fake police officer .	a man and a woman dressed as a prisoner and sexy police officer .
an older man is standing outside in front of a truck .	a woman dressed in green is roller skating outside at an event .
two little girls are playing on a trampoline .	two blond girls are playing together .
smiling man with reflective classes .	a gentleman smiling and showing his reflective sunglasses .
five people standing on a sidewalk	five people on a sidewalk .
a boy stands in the pool at the bottom of a blue water slide .	a boy splashes into a pool , ejected from a water slide .
a man is backpacking up a grassy hill .	the hiker is following a trail uphill .
two teenagers huddle in a doorway in the rain .	two people wearing hoodies huddle on a doorstep in the rain .
two girls in blue and teal dresses and large hats are standing next to a large tree trunk .	a woman , a little boy , and a tiny baby are standing in front of a cow statue .
the child has a necklace on and is in the water .	a child in orange is on a boogie board in the waves .
the white dog runs across the snow .	a white bear walks along snow-covered ground and casts a shadow on the snow .
a group of football players running down the field .	football players are on the field .
a group of picnickers sit under an umbrella .	a group of people are laying in the grass under an umbrella .
two brown dogs playfully fight in the snow .	two brown dogs are running on the sand .
a young boy in a brown jacket playing with snow .	two dogs are playing in the snow .
two boys are running around a field .	two dogs are running in the field .
a hiker carrying a backpack is walking past a waterfall .	a hiker with a backpack is walking near a waterfall .
a boy in a blue shirt and shorts jumping a bike with a ramp .	young boy on bicycle jumping off a ramp .
three dolphins are jumping out of a pool in front of a crowd of people .	a man is giving a presentation in front of a lot of people .
a man picking up a big rock .	a woman picking up a large rock .
a white and brown dog is running over grass .	a brown and white dog is running across the grass .
two people dressed as animals near a crowd .	people in animal costumes entertain a crowd .
the dog is running through a field .	a dog runs through a field .
a black and white dog is jumping into the water .	a white dog runs across the water .
two black dogs playing in the snow .	two dogs playing in the snow near a chair .
man is carrying a tool box down the sidewalk .	a woman is riding a blue bicycle in a park .
a man wearing a t-shirt that says " gigolo " stands at the counter talking to someone .	a man wearing a shirt that says " gigolo " is standing at a front desk area with his back to the camera .
a tent and a campsite in a sunlit forest .	a white dog on a beach is carrying a stick in its mouth .
two large dogs running in some grass .	two brindle dogs running in the grass .
a dog swimming with a stick in it 's mouth .	a dog running with a stick in it 's mouth .
a group of four hiking through a snowy forest .	a group of people hike through a snowy wooded area .
two black dogs playing in the snow .	a dog playing in the snow .
a dog is running through tall grass .	a dig is trekking through snow .
a woman is sitting up asleep with her head resting on her hand .	a man who is resting his head on his hand .
a young boy jumping into a lake .	the boy is jumping into a lake .
a little boy , in a camouflage jacket , looks at a display of many yellow rubber ducks .	a young boy looks at a display of rubber ducks .
man on skateboard on top of rust colored barrel in darkened area .	a man and a skateboard on top of a barrel .
a surfer rides up the wave .	the surfer is in the wave .
two guys are playing with two dogs on the beach .	two boys play with two dogs at the shore .
light brown dog running towards something at the beach .	a brown dog chases a blond one in the grass .
a group of people near a fun house at a carnival .	a group of people are looking and taking photos of something off camera .
a man playing fetch with two brown dogs .	a woman plays with a brown dog .
a tan and white dog retrieving a ball on a gravel path .	a large dog walks along a gravel path in the woods .
two people and a dog are in the snow .	two people playing on a snowy hill .
a dog is running across the sand with a stick in it 's mouth .	a dog is running through a creek with a stick in its mouth .
a man is standing in water near a waterfall .	a man wades in the water and watches a water fall .
a black dog is chasing two birds on the shore of the ocean .	a dog is running along the beach beside the ocean .
a surfer is riding on a breaking wave .	a surfer is riding a wave .
a man and a woman on a bench .	a man and woman sit on a park bench .
three dogs are playing in the white snow .	a dog is playing in the deep snow .
a little girl takes a picture while mom watches in boredom .	a little girl in pajamas takes a picture with a camera
a greyhound jumps over a chain .	a dog jumps over a chain .
a tan dog jumps up to catch a tennis ball .	a red dog jumps an catches a tennis ball in its mouth .
a child in blue shorts is standing ankle deep in the water .	a little boy in blue shorts , glasses , and a coat stands in the surf .
the man is jumping into the water .	the man is up in the air .
a black and white dog is running through the grass .	a black and white dog is jumping in the grass .
a woman in a black shirt stands in front of bananas at a fruit stand .	a woman wearing black stands in front of a pickup truck .
a child is jumping into a swimming pool .	a dog jumping into a swimming pool .
two dogs are gnawing at a blue and yellow ball .	two dogs playing with a blue and green ball .
man and child skiing .	a child goes skiing .
two black and brown dogs are running through a field .	two dogs are running together outside .
a little boy jumping from one chair to another .	a young boy jumping from one chair to another in his house
a girl swings her long , wet hair in a lake .	a person riding a dirt bike .
two dogs playing by the shore .	two dogs playing in the snow .
a little girl walks on a boardwalk with blue domes in the background .	a man going over a jump on his bike with a river in the background
a brown and white dog is walking up snowy steps .	a black and white dog frolics in the snow .
the brown dog is laying down on a blue sheet .	a brown dog and two black dogs in an overgrown grassy field .
a young man wearing a green shirt in jumping in the air	a tan dog watching a brown dog swimming in a pond .
a brown dog jumps over hurdle with flames on each end .	a light brown dog jumping over a hurdle that has fire on each end .
two women sitting on a bench , their faces obscured , with one woman carrying an inflatable tiger and the other woman in a disney snow white costume .	a girl sits on a bench holding an inflatable tiger next to another girl in a colorful outfit .
a guy and two girls are smiling at the camera .	three dogs , one white and two brown , are running together on a field of grass .
a dog swimming with a stick in it 's mouth .	dog swimming in the water with a stick in its mouth .
a person snowboarding and jumping over a construction sign .	a long snowboarder jumping over a barricade outside in the snow .
a black poodle plays in the snow .	a black poodle frolics in the snow .
two officers with orange jackets stand outside a white tent with onlookers .	men with hats on stand outside of a white tent .
a black dog catches a tennis ball in his mouth while a white dog watches .	a black dog jumps to catch a ball in his mouth near a rock wall .
two girls holding up a scary movie flyer	two girls holding sacks are standing in a field .
two small dogs run through the grass .	a dog runs through the woods .
three boys are running on the beach playing a game .	two young boys and one young man run on a beach with water behind them .
two dogs in water as a man looks on from a dock .	two dogs are running in the water while a man watches from the dock .
the kids ride a boat in the water .	the four kids are riding a raft on the water .
a girl is wearing a purple sash and matching skirt .	a group of girls stands wearing jean skirts and superman shirts .
a large white bird swoops over water .	a large white bird flying over water .
a man takes photos on the water 's edge .	a bald man is taking shots of a body of water from a camera .
two dogs fighting in the snow .	two dogs standing in the snow .
the man and two young boys jump on a trampoline .	a man and two boys are bouncing on a trampoline .
a small child slides down a purple slide .	a girl slides down a purple slide .
a man wearing a grey jacket standing on the side of a street .	a boy wearing a blue life jacket is holding onto the side of a green boat .
a brown and black dog is jumping to catch a red ball .	a brown and black dog jumps for a red ball .
a black dog walks through some water .	a brown dog walks through snow .
the tan dog runs through the leaves .	the white dog runs through the ocean .
a white and black dog is jumping into a pool .	a woman in a black apron is standing in front of a mirror .
a black and white dog is carrying a stick in its mouth .	the black and white dog has a stick in his paws .
a deer jumps a fence .	a deer jumping over a fence .
the black dog carries an object in the snow .	a black dog carries a white toy in his mouth and walks on the snowy field .
a man dressed in a batman costume .	a man is posing dressed in a batman costume .
a little girl holds a wooden stick .	a little girl swimming in a pool .
a black dog jumps through the water .	a dog walks through the snow .
a group of people in front of a red fire truck .	a group of people are standing around a red fire truck .
a man wearing a red bicycle helmet talking on a cell phone with other people in the background .	a man in a bicycle helmet is talking on a cell phone with other people behind him .
a boy jumps into the blue pool water .	the young boy is jumping into the pool on his belly .
a blonde dog is catching a ball in its mouth in the snow .	a little blonde girl is sitting on a green chair .
three children and playing and laughing on the floor .	three children playing on the floor .
a man sits with fishing poles near a body of water .	a man sits on a rock next to a folding deck chair and a fishing pole .
someone fires a bullet from a handgun into the woods .	a close-up of a man shooting a handgun into the woods .
a woman and a dog standing in the grass .	a man carries a sign while standing in the rain .
two dogs are playing in a grassy field .	two dogs play in a sandy field .
a man in an orange shirt playing tennis .	a man wearing an orange u. miami tee shirt playing tennis
a man in a blue shirt is running in a stadium field .	a man wearing a blue hat and shirt is riding a white horse .
a brown a white dog runs down a yellow and blue ramp .	a brown and white dog exiting a yellow and blue ramp in a grassy area .
a woman in a black and orange jacket throws a stick for a brown and black dog to fetch .	the man in a blue jacket is standing in a crowd .
a girl jumping on a sand dune at the ocean .	the little girl jumps up into the air with the sand beneath her .
a black dog running through water .	a black dog is running through some water .
children jumping on a trampoline .	a man is sledding on an orange slide .
a large brown dog is crouching in a grassy field .	a brown dog is running in a field .
a child playing on a playground play set .	a child swinging on a playground play set .
a man practicing boxing	a man practices boxing
two woman looking into a glass case .	a young woman in a bikini looking at something in a glass case .
a girl with a purple and white helmet is riding on a scooter .	a girl wearing a helmet rides a scooter .
a little boy in a helmet is doing tricks on a skateboard .	a young boy is completing a jump on a skateboard .
a dog runs through the grass .	a dog runs through the snow .
the girl with the blue bucket splashes beneath the pier .	the girl in the ski jacket is walking near the buildings .
a skier speeds through the snow .	a brown dog carrying a frisbee runs through the snow .
two people are playing golf on a golf course .	two people are on a golf course playing golf .
a boy and a girl playing on the beach .	a dog playing in the waves with a ball .
a dog running across the snow with a snowball in it 's mouth .	a tan dog is running through the grass with a yellow toy in its mouth .
a girl wearing a brown cap , red sneakers , and a dark green coat sits on a rock bench .	a woman in a knit cap and green coat its on a stone block , looking out .
the child in the red coat laid in the red mat .	the toddler is ready to climb the red piece of equipment .
two dogs play in the grass .	two dogs are playing in the grass .
two dogs running on grass .	two black , wet dogs running on grass .
a group of people stand in the sand looking out at the water .	a group of people are standing on the beach in front of some boats .
a dog leaps over a barrier .	a dog leaps over a fence .
a child in a blue and white team uniform chasing a soccer ball .	a young boy in a blue soccer uniform chasing a ball .
a child soccer player runs for a ball near the goal .	a young boy runs towards a blue soccer ball in front of a goal .
a girl , in a black shirt and hot pink pants , is about to hit a tennis ball on the court .	a girl wearing pink flip flops and tights is swinging a tennis racket at a tennis ball .
a softball player swinging at a pitch .	a baseball player hitting the ball
a black dog is running after a white dog in the snow .	black dog chasing brown dog through snow
the bmx bike rider jumps a grassy dirt ramp .	two bmx bikers jumping dirt ramps in front of a body of water .
the brown dog is about to bite a paw printed ball .	a dog with fangs revealed is about to bite a ball with paw prints on it .
a man is kite surfing away from the camera .	a man is sky surfing on the water .
two young women sit by a fountain .	two blond women are sitting by a fountain .
a boy standing and watching a group of people on a basketball court .	a boy standing in the foreground looking out over other people in a court .
a race car moves down the road as two people watch from a distance .	silver and blue car marked 104 raises dust on road as two background people watch .
the brown dog is running on the grass .	the skinny brown dog is running through the tall green grass .
man holding a stick while a dog jumps up to grab it	a bald man in grey is holding out a stick whilst a black and brown dog jumps up to catch it .
a small boy is building with some wooden blocks .	a small boy wearing a blue shirt stacks wooden blocks .
a black dog is running in the grass .	a boy running through green grass .
a little boy and a little girl playing together outside .	a young boy and a young girl walking towards each other
two people sit on the end of a dock .	two people sitting on a dock .
a child cavorts on the road .	a white dog runs on the grass .
a black dog runs through a muddy bank .	a lean dog runs through a wooded area .
two dogs in a yard .	two dogs in a stream .
four people standing outside of an outdoor ticket booth .	four people wait outside in a line for ticket .
dog with a thick collar running through the grass	a black dog with a red collar runs through grass .
a man chases a dog trying to pass the barrier to enter a play area .	a man follows his black and white dog as it takes on an obstacle course .
a man and his dog play tug of war with a rope .	a man and a dog are playing tug of war .
the large brown and white dog is running through the snow .	st. bernard dog running in the snowy field .
a boy and a dog running on grass	a black dog , running on grass .
a dog runs across the grass .	a dog runs across the path .
a small white dog running across a lawn .	a small white dog running
the white dog is running in the shallow water .	a wet dog is splashing through shallow water .
a dog racing on a track .	a dog chases another by a tree .
the white and brown dog is running quickly through the grass .	the big white dog is running in the grass .
a young baby girl wearing a white outfit swinging in a baby swing	a young girl wearing a black and red swimsuit swinging on a swing
four hooded children huddle under a blanket outdoors .	four children keeping warm under a blanket .
two children in the bathtub with an umbrella .	two children with a yellow and blue umbrella play in the bathtub .
a person in a striped fleece clips a carabiner onto a metal line .	a young woman in a helmet attaches a pulley to a cable .
a bloody man and woman pose for a picture .	a man in woman dressed warmly pose for a picture .
a black and white dog is running through a snowy field .	a black , brown and white dog running through a field .
a man and a woman walk with a white dog on a leash .	a man , woman and dog walk down a paved road .
a white dog with brown spots is chewing on a ropey black toy .	a white and brown dog playing with a black toy .
a small brown dog jumping up to catch a tennis ball .	a wet dog chasing a white ball
three boys playing soccer in a field	three boys playing soccer .
a young boy wearing a blue visor swings a bat .	a young boy with a visor on plays ball with his bat in the street .
a brown dog walks in the grass with it 's tongue hanging out .	a grey dog walks in the green grass , tongue hanging out .
five men dressed in tuxedos standing on a set of stairs	five men in tuxedos are walking down steps .
two dogs running in a field .	two dogs running in the dirt .
a black dog and a tan dog fighting .	a black dog and a spotted dog are fighting
a little brown dog is running on the grass .	the brown dog is running on the grass .
a yellow dog is playing in a grassy area near flowers .	a girl is playing on a swing .
a boy plays with a noodle by the pool .	a boy plays with a foam noodle toy by a pool .
a bike rider on a ramp .	a bike rider makes a jump on a halfpipe ramp .
two big brown dogs running through the snow .	a brown dog running through the grass .
a young boy jumps into a pool with outstretched arms .	a dog jumps into a backyard pool .
an older dog and a younger one playing with a toy .	two dogs in a house playing with toys .
two dogs swimming in a pool .	a dog and a cat are swimming in a swimming pool .
a skateboarder sliding on a rail .	a skateboarder doing a jump .
a girl holds up a yellow balloon animal .	a child holds a yellow balloon .
a child in a white shirt standing in a field of grass .	a brown dog in a superman shirt is laying on a blue blanket .
two dogs share a toy in a field of vegetation .	two snowboarders are in the air over the snow .
two white dogs run through a fiels with snow .	two white dogs running in the snow .
a black dog is running in the grass .	the black dog is running through the grass .
a blond haired lady in white poses for the camera .	a black and white dog runs with its mouth open .
a boy is rollerblading in a skate park .	a young boy rollerblading in a cement skate park .
a young girl on rollerblades .	a young girl with roller blades and green foliage in the background .
the large brown dog is running through shallow water .	the white dog is running in the shallow water .
a dog runs through a field chasing a ball .	a child runs through the grass .
two dogs playing on the beach .	two dogs running on the beach
a dog jumps over a barrier in a field .	a dog jumps over a chain .
a hiker passes a white rock formation in the middle of an empty desert .	a hiker discovers a feature in an otherwise barren landscape .
two girls are sitting in front of a statue .	two blonde girls are sitting next to a statue
two young children jumping off of a cement ledge onto the dirt ground .	two children jump on a trampoline .
a light-colored dog runs on the beach .	a small yellow dog runs on a beach
a young boy wearing a red winter coat is eating and holding up a candy bar .	a young boy wearing a red coat eats a chocolate bar .
a girl in orange lights a candle .	a girl in an orange shirt lights candles .
a white dog runs through a field of yellow flowers .	a dog with a red collar runs in a forest in the middle of winter .
a brown and white dog runs through the green grass .	a brown and white dog runs across the grass .
an infant sitting on a cot reaching over to touch the face of an older boy .	a boy who seems ill is being touched in the face by a toddler .
a red-haired girl is jumping by a swan .	a red haired girl is jumping towards a swan .
the dog jumps in the air running after the frisbee .	a tan and white dog jumping after a red frisbee .
a dog shaking off water .	a dog shaking water off .
the dog is playing in the water .	a dog is wading in the water .
young boys running along the pavement .	a black dog running along the edge of the ocean .
a young child slides down an orange slide .	a little boy in denim overalls slides down an orange slide .
a black and white dog running through some red and white poles	black and white dog in living room standing on hind legs .
a white dog is running through the water onto the shore .	the white dog runs through the ocean .
a boy goes down an inflatable slide .	a child going down an inflatable slide .
three individuals are posing on skis behind a " no skiing " sign .	three people on skis are standing behind a no skiing sign .
a man in a white suit walks down the street holding a newspaper .	a man in a white suit walks outside carrying a newspaper .
a man with his bike amid a demolished building .	a man sits on the stairs next to his bike .
a black and white dog swimming in clear water .	a small black and white dog is swimming in water .
two racing dogs run in the mud .	the man is going into the water .
a bird with it 's wings spread	a bird soars with wings spread .
two black and white dogs run across a green field .	a white dog is running across a grassy field .
a young boy jumping into a pool that says " no diving " .	a boy jumps into a pool while lifeguards watch .
a black dog with a blue collar is running in the snow .	a black dog wearing a blue collar is running through the snow .
a dog catching a ball .	a dog catching a frisbee .
black and white dog running through water .	a black and white dog is running through grass .
a man in a grey t shirt is sitting on a rock in front of a waterfall .	a person sitting on a rock beside a waterfall .
brown and white dog with a baseball in its mouth .	a black and white dog stands on the grass with a baseball in his mouth
a dog is running toward the camera .	a brown and white dog running on grass .
three dogs running in the dirt .	the yellow dog is running on the dirt road .
a boy swinging on a swing .	the girl is on a swing .
a cook steps back as flames leap from a pan in a kitchen .	a woman at a stove jumps back from the high flames of a pan .
a man and a woman are sitting on a dock together .	a man and a woman are walking across a rope bridge .
a group of youngsters swim in lake water	many children are playing and swimming in the water .
a blue and white soccer team playing against each other .	a topless woman with her face painted is covered in mud .
two dogs running in the snow	a dog laying in the snow .
a golden dog is running through the snow .	a pack of sled dogs pulling a sled through a town .
a brown dog about to catch a green frisbee .	a brown dog waits for the frisbee to come down before catching it .
a skateboarder on a city street .	a skateboarder in the air at a big , outdoor ramp .
four children on stools in a diner .	four children sit on tall bar stools at a yellow and grey bar .
boy and white dog running in grassy field	a boy and a dog running on grass
two large dogs are running together through the grass .	two black dogs are playing on the grass .
a brown dog is running in the grass .	a dog running on the grass .
a dog is jumping over a log with ears flying and tongue out .	a dog leaps over a log in the woods .
a black and white dog is swimming in a large green lake .	a black dog runs fast into shallow water .
two large black dogs are playing in a grassy field .	two white dogs are running together .
two boys playing a game of flag football .	two boys are playing flag football .
the brown and black dog sprints across the snow .	a black dog is running quickly along the ground .
a man in a black jacket is taking a photo of a man in a red jacket .	a man in a black outfit is taking a photograph of a man in a red jacket .
the man in the backpack looks to his left .	an adult male wearing a backpack walks and looks to the left .
an elderly man in a blue shirt is holding up a piece of canvas art .	a black man is walking next to a building in a big city .
a dog is carrying something pink in its mouth while walking through the snow .	a dog with something pink in it 's mouth is looking forward .
two skinny young boys playing with sand in the water .	two dogs are shaking water off .
the black and white dog has its mouth wide open .	a black and white dog jumps in the snow .
a small dog runs through an obstacle course .	a small dog jumping over an obstacle .
a brown dog shakes off water after exiting a natural pond .	a dog shakes off after getting out of the water .
a girl bounces in a bounce house .	a girl dances like a man in costume
a brown dog swimming in murky water .	a tan dog swimming in some water
a brown dog running through the woods .	a brown dog runs through the grass .
a group of people are standing by a window watching something .	a group of people stand and wait to see something .
a young man with a mullet smokes while sitting on a unique couch .	young man in a black shirt smokes on a sofa in a colorful room
a dog is jumping over a barrier at a agility competition .	a dog jumping over an obstacle course fence .
three people racing on ice skates .	three ice skaters round a corner .
a large brown dog is walking along side a river .	a brown dog walks on the rocks near a river .
one white boy and one black boy stand with arms around each other .	two young boys , one white and one black , are standing with their arms around each other .
two women contestants are walking their dogs in a dog show .	two women walk there dogs at a dog show .
a boy falls off his red bike .	a young boy falls off his bike .
two men on the side of a barge	a man is lying the grass with long hair and beard .
a brown and white dog is catching a tennis ball while standing on its hind legs .	the brown and white dog is carrying a stick in his mouth .
a brown dog in running on grass .	a brown dog runs through the grass .
a man with a white headband playing drums .	a boy in a headband plays drums .
two dogs holding one frisbee in their mouths .	two dogs holding a single black frisbee in their mouths
two dogs are running through a small pond	two dogs are running quickly through a park .
a wet black dog with a red collar is in the river	a black dog with a red collar wading through the water .
a black and white colored dog jumping around in a body of water .	a black and white dog swimming in clear water .
kids are riding horses in a ring .	two children are riding horses over sand near a white fence .
a person is riding their bike on a trail next to the woods .	a small child in a yellow shirt is holding their arms out to the sides .
the two black dogs are running through the grass .	two dogs running on grass .
two cold people stand near a pole .	two people wearing winter clothes stand near a pole in a winter scene .
a woman in a black dress smiles in front of a silver truck .	a girl wearing a black top is smiling with a silver truck in the background .
two dogs are running across a grassy path .	two dogs are in a grassy area .
girl playing in a puddle with her bare feet .	a child is playing with two white and black geese .
two people are walking by the ocean .	two men in fleeces and hats looking at the camera .
a man in red takes cell phone pictures at a football game .	a man in a red shirt is watching a football game .
a grey dog jumps to bite a green leash .	a brown dog jumps over a wire fence .
two little girls in pink are dancing .	two ladies jogging on a path near the waterfront .
a black dog runs through the dry grass .	a black dog running through water .
a white dog with black markings runs through the snow .	a white dog with tan ears is running through the snow
two children splashing in the water .	two dolphins jumping into the water .
a dog is on the beach near a ball .	a guy is going up for a lay-up on a basketball court .
the child is looking at santa claus .	the child is looking at his reflection in glass .
a man is standing in front of a skyscraper	there is a skyscraper in the distance with a man walking in front of the camera .
two woman climbing rocks around the ocean	two women climb on top of rocks in front of the ocean .
a brown dog is running through the grass panting .	a brown dog running through grass .
a dog bounds across the brown grass .	two dogs bound across the grass .
the dog runs through the water .	a dog runs through shallow water .
a woman playing with two young boys at a park	a woman and three kids play at a park .
a dog emerges form the water with a stick in its mouth .	a dog runs toward the camera with a stick in its mouth .
a brown dog playfully bites a white dog .	one dog makes a playful bite on another dog .
the large dog wading in the water and shaking .	three dark dogs swimming and one of them has a ball .
three dogs playing in the snow .	the boy is playing in the sand .
a woman in jeans plays a video game in front of a large screen .	a man and a woman are posing for a photograph in front of a yellow flower-bed .
children jumping on a trampoline .	five children jump on a large trampoline while the snow outside melts .
a boy in a grey hat is carrying a soccer ball by a reddish colored wall .	a small boy is carrying a soccer ball .
two people walking along the shore at sunset .	two people walking along the beach at sunset towarn a group of people .
a white dog running on the beach .	a dog running in the surf .
a man in a suit dances with a young girl in front of an audience .	a women dangles from a blue fabric connected to a tree .
a light brown dog is running in the water .	a white dog running in the snow .
three children playing on a floor with toys .	three children sitting in floor playing with several toys .
a dog comes out of a blue baby pool with a ball in his mouth .	a dog comes out of the water with a ball in his mouth .
a dog carries a leash in its mouth .	a fluffy dog carries a black leash in its mouth .
two children playing in the snow .	children play in a pile of snow .
a dog holding a ring in his mouth is standing in a small river .	a dog with a ring in its mouth is standing in water .
a man in jeans is playing with a ball while a woman in jeans stands nearby looking away .	a man is tying a red arm band around another mans arm in the street .
a black dog is running through the snow .	the black and brown dog is running through the snow .
a woman in a pink bikini is laying on a deck lounge chair that is covered with a pink towel .	a woman in a white shirt and black skirt on a tennis court .
a skier is falling into the snow .	a skier is falling face first into the snow .
a dog with a red toy in it 's mouth .	a brown dog is carrying a stick in its mouth .
two hockey players fighting on the ice .	two hockey players in a struggle on the ice .
three people stand in an outdoor glass structure .	a girl stands high on an obstacle course platform .
two terriers play on the wood floor of their home .	two puppies play with a red chew toy in a field .
the person is doing a handstand on the beach .	a kid is doing a hand-stand on the beach .
a group of people are at a convention waving american flags .	a crowd of people at an outdoor event
two dogs running through a field .	two dogs play in a field .
a man in a gray suit locking up a bicycle	a man and a woman standing on a city street .
the two dogs are playing in the yard .	two dogs are playing on the grass .
two dogs groom each other .	two dogs jumping on each other .
a man in a black wetsuit is surfung in the waves .	a surfer in a black wet suit surfs on a medium wave .
two dogs playing in the water .	two boys playing in water .
a deer is jumping over a fence .	a kid is jumping his bike over a fence .
a bird with it 's wings spread	a bird flying in the air
a boy skateboards down the railing of some graffiti stairs	a skateboarder is jumping over an obstacle in front of a white house .
a white dog is running through the water at a beach	a white dog is running through the water onto the shore .
a man in a black leather jacket is sleeping in a subway car .	a man in a black leather jacket falls asleep on public transportation .
a black dog jumps in the snow .	a dog jumps high in the snow .
a dog leaping over a hurdle .	a dog leaps over the hurdle .
two men are setting up some electronic equpitment	two dogs are wrestling on the ground in the snow .
a black dog is walking on the grass with a stick in it 's mouth .	a boy holds a net with a snake in it close to the ground .
a man and woman blow bubbles .	a man and a woman in glasses blow bubbles .
a girl runs with dogs in a dry field .	a grey dog and a tan dog playing on a grassy field .
two dogs playing in the snow .	two black dogs in the snow .
a dog running through mucky ground .	a dog runs through sand .
a brown and white dog standing in a yard .	a black and white dog playing in the sand .
a skateboard performs a trick off a quarter pipe .	a skateboarder attempts to do a trick over a homemade ramp .
two woman sit on a park bench .	two women sitting on a bench by the water .
a brown dog lunges for a yellow toy .	a brown dog chasing a yellow toy .
a tan dog jumps up to catch a tennis ball .	a small brown dog jumping up to catch a tennis ball .
a dog leaps off a dock and into the water .	the black dog leaps off the dock and into the water .
a group of old men walking down the street	a couple walking down the street .
three dogs are up to their necks in water .	three black dogs swimming in dirty water
three dogs standing in snow next to a blue fence .	three dogs play in the shallows next to a rocky shore .
a white dog snarls at a black dog in front of a set of steps .	a white dog , a brown dog , and a black dog frolicking in a grassy field .
snow boarder on a pink board flying through the air .	a snowboarder is jumping over a snowy hill
a black and white dog is running through the field .	a black and white dog is running in the grass .
a boy in black waves his arms while other people are behind him on a field .	a man in a black shirt is roller blading past a bench in the city .
an elderly woman rides a bicycle along a city street .	an elderly woman walking uphill crossing the street .
a girl in a costume participates in a parade .	a girl in a red and white costume standing on the street .
the black dog runs through the water .	a dog is jumping through the water .
a young boy is punching a yellow ball .	a small dog jumps over a yellow beam .
a little girl is shoveling snow .	a little girl is running .
a man with his arms raised at the top of a mountain .	a person in a red shirt is standing , with arms raised , at the top of a mountain .
a man sits on a wooden bench next a tree and some cacti .	a man wearing a hoodie and jacket is sitting on a bench in a park .
a group of young ballerinas are in a dance studio .	a group of young ladies in bikinis .
a person is surfing a big wave .	a surfer rides out the green and white waves .
a young boy in a white dress shirt is playing on a grassy plain .	a woman is getting her hair done at a salon .
a dog running through snow .	a collie running through the snow .
a woman and a man are amused by headphones .	a man and a woman resting after exercise .
two girls walking in the ocean .	two girls walking in the street
a young boy jumps off of a plank into a lake .	a young boy jumping into a lake .
the # 2 greyhound dog is running around a track .	a muzzled greyhound dog is running around a track
a man and a dog are playing tug of war .	a man dances on a colorful wall .
a wet child shivers under a towel at a pool .	a wet child is shivering in a towel in front of a pool .
a brown and white dog swims in a backyard swimming pool .	a brown and white dog is paddling through deep water in a blue container .
a white dog runs on a beach .	the white dog is running along the beach .
six dogs running on the sandy beach .	six dogs walking beside the beach .
a man holds on to a handle in the water .	a man is holding onto handles in the air .
four children are playing on a trampoline .	four kids are jumping on a trampoline .
a white dog walking in the snow .	a black and tan dog walking through the snow .
two older men in front of a bus .	two men step off the bus together .
the white and brown dog runs across the grass .	three dogs are running on the grass .
a black dog retrieves a bird .	a black dog fetches a dead bird .
three dogs on grass running towards the camera .	several large dogs are running through a large grassy area .
a boy goes down an inflatable slide .	a boy in red slides down an inflatable ride .
two dogs playing with a ball in a puddle .	two dogs stand in a puddle , and one has a yellow tennis ball .
three dogs are playing in the water .	three dogs run in the snow .
two dogs playing in the snow .	two kids playing with a dog .
two black dogs playing in the snow .	two dogs play in the snow
many cars parked on a mountain .	a group of cars parked on a hill
a girl does a back bend on the beach .	a girl doing a back bend at the beach .
a white dog in a jump , holding a plate in his mouth .	a dog jumps in the air , catching a frisbee in its mouth .
boat sails in rough water .	a man is kayaking in rough waters .
a girl sits on a red play structure	a little girl on a red jungle gym .
the two dogs are playing fetch in the snow .	two dogs are playing together in the grass .
a black and tan dog standing in a field near trees	a white dog is standing by a river shaking himself dry .
two surfers on riding a small wave .	two surfers perform tricks in the waves .
a gray bird is flying over the water .	a bird flying over the water .
two people walking on the beach at sunset .	two people walking along the shore at sunset .
a dog jumps high in the snow .	a dog runs in the snow .
three dogs are playing in the white snow .	two dogs are playing in the grass .
a child sprinkles confetti in a woman 's hair .	small girl in an apron placing confetti in a woman 's hair .
a dog runs through the water .	a dog runs through the grass .
the man in the red shirt is climbing the side of a mountain .	a man with the monster logo shirt is surfing .
three boys playing soccer in a field	three boys playing soccer .
two puppies playing around in the grass	two dogs are wrestling in the grass .
a young girl is sitting on santa 's lap .	a little girl is sitting on santa 's lap
two people raise their arms on a snowy hill in the mountains .	two people kneel on the snow and raise their arms with mountains behind them .
a dog is looking at something near the water .	two teenage girls are texting in the park .
a black and white dog runs with its mouth open .	a black and white dog swims in blue water .
a black dog running into the water .	a black dog running through water .
a young boy jumping in the air at the beach .	a boy jumping in the air on the beach .
a woman and a dog rowing down a wide river .	woman and dog in rowboat on the water .
a group of young asian children pose for a picture at a table .	a group of six children sit at a wooden table .
a white dog bounding through snow	a large white dog is bounding through a snowy field .
five men in tuxedos are walking down steps .	five men in tuxedos walk down a set of steps
two children hug one another .	two men in hats pose together .
man in red shorts and white shirt kicking a soccer ball .	a black dog stands in the surf holding a red rubber ball .
two girls next to a mossy tree .	two girls lean around a tree , laughing .
an old man sitting down watching something .	people stand outside watching something .
a man and dog on a rocky seashore .	man and dog standing on rocks next to water
brown dog splashing into the water .	four dogs splashing in the water
a boy wearing a blue jacket swings a bat at a white ball .	a young boy in a blue jacket swings a bat at a ball .
a woman with a knit cap on is smiling near a domino 's pizza sign .	a young woman with a knit cap stands against the wall of a domino 's pizza .
the smiling woman at the beach is buried in seaweed .	a girl in a cowboy hat with a sheep on a leash .
the man in the brown jacket is sitting on the ground by the jetty .	a woman who is ski-ing poses for the camera .
many people are eating in a crowded restaurant .	diners sit at tables in a crowded restaurant lit in blue .
a white dog with brown spots is running in a yard , chasing a ball .	a white dog with brown markings chases an orange ball in a grassy field .
two dogs , the white one standing on a frisbee , playing together on grass .	two dogs play on the grass .
a dog with big ears is holding a small stick in it 's mouth .	a puppy with big ears chewing on a stick .
the large brown dog is jumping through the tall grass .	the girl wearing a blue shirt is running through a science center .
two dogs fighting in the snow .	two dogs playing in the snow .
a snowboarder goes down a ramp .	a snowboarder going over a ramp .
a small dog jumping with a ball in its mouth .	there is a brown dog swimming outside with a tennis ball in its mouth .
a brown dog is in the middle of a line of dogs chasing a dirty tennis ball over dirt .	there are two white dogs and one brown dog chasing a ball .
a swimmer doing the breaststroke in a pool .	a swimmer swimming butterfly in a pool
a golden dog is running through the snow .	a black dog is running through the snow .
a grey hound is active in a grassy field .	a bunch of bikes racing on a track .
three dogs walking in the grass .	three dogs playing in the green water .
three dogs playing in the snow .	two dogs playing or fighting in the snow .
two people are racing a sidecar motorcycle in the mud .	the dog carrying a long stick in its mouth .
a man in red swim trunks playing volleyball .	a man and woman sitting on a motorcycle .
a man and woman walking past a record shop	a man and woman kissing in front of a crowd of people .
the man is sitting at the top of a rocky mountain .	a person sticks their head out of a tent at the top of a mountain .
two people in snowsuits laying in the snow making snow angels	two children lying in the snow making snow angels
a little blonde girl is standing in front of a water fountain .	a young girl standing in front of a fountain
a blond dog and a black and white dog run in a dirt field .	a yellow dog and a black and white dog are running in the dirt .
a man is tying a red arm band around another mans arm in the street .	a man helps tie a red ribbon around another man 's right arm during a street parade .
a man standing on a boat is pulling another boat close by with a bamboo stick .	a man in a black hat standing in front of a brick wall and a sign
a man plays his white guitar .	a man playing a white guitar and singing as well
a person is skijoring with a dog in the mountains .	a brown dog is playing with a ball in the water .
a black and white dog is running in grass carring a big stick .	a black and white dog is playing in a pond or creek .
two girls are fighting over a ball during a game .	two dogs either fighting or playing together .
two shirtless young people playing in the water .	lots of people play in the water at the beach .
two young children are on sand .	two young children wearing sunglasses
a black and white dog runs through the water .	two black dogs run into the white waves on a beach .
close-up of a hummingbird .	a closeup of a hummingbird flying .
two dogs play in the grass .	two tan dogs play in the snow .
a young man is wearing a black jacket and has white earphones in his ears .	a man in a black jacket is has a white headphone in his ear .
woman in a black dress walking on the street .	a woman watches a dog jump down the stairs .
three children wrestle on a floral carpet .	three children playing on the floor .
a boy in red jumping into a sandbox .	a dog swimming in a pond
three dogs play by a lake .	three dogs playing on grass .
the brown dog is playing in the snow .	a black dog is playing in the snow .
the girl in a pink shirt jumps high over the grass .	a girl jumping in the grass .
a man and a woman looking at the camera .	a man and a woman laughing .
a dog jumps into the water .	a dog is jumping into the water .
a brown dog running through the dirty muddy grass	the large brown dog is running outside in the dirt .
the black and white dog jumps with a tennis ball in its mouth .	a white dog with a collar is running .
three dogs pulling a man on a bicycle through the snow .	the dogs are pulling a man on a type of bike , through the snow .
a boy riding on a swing .	a young boy riding in a swing .
a man in a batman suit running .	a man in a batman costume is running a race .
a brown dog is digging in the dirt .	a dog is digging a hole in the dirt
a dog is running along the grass .	a brown dog is running on grass .
two young girls with dyed hair talk to two boys in black .	two girls with pink streaked hair and two boys with black hair standing next to a concrete building .
a black dog running through the snow .	a black dog runs through the water .
a young child blows on an orange wand to make a bubble .	an asian child is blowing bubbles from an orange bubble hoop .
a tan and white dog looks scared while splashing in the water .	a brown and white dog swimming in water
a baby in a red hat sitting in a stroller is holding a doll .	a man in a gray shirt sitting in a field of flowers .
two white dogs running in grass .	two dogs running in the woods .
a man is standing on top of a mountain gazing at the sunset .	a man standing in the mountains watching a sunset .
three children playing with hay outdoors , throwing some at camera lens .	three young children play in the hay , throwing some at the camera .
a black dog walking beside a pool .	a black dog is walking along the side of a pool .
two dogs standing in a lake .	two dogs playing on grass .
five black dogs run in a field .	a black dog is running across a field .
four dogs run in the grass .	a dog running in the grass .
a little black dog is running on the snow .	a black dog is running through the snow .
a wet white dog is splashing in the water with a stick in it 's mouth .	a white dogs treads the water with sticks in its mouth .
the white puppies are playing on a couch with a baby bottle .	three puppies are lying on a couch beside a baby bottle .
a dog running with a tennis ball in his mouth	a dog swimming with a stick in it 's mouth .
a black , brown , and white dog is carrying a frisbee .	a black and white dog is catching a frisbee .
a large black and tan dog is running across the snow in a wooded area .	the black and brown dog is running through the snow .
a climber is standing on the rock face next to the pink rope .	the children are running in the snow with fences in the background .
a dog with a yellow toy in its mouth .	dog trotting with a rubber duck in its mouth
a man is standing in front of 4 dogs on the beach .	a dog running on the sand by the beach while his owner looks at the other dogs on the beach .
the man is wearing a black shirt and hat and smiling .	a man is lifting a little girl above his head .
a black dog wearing an orange collar is entangled with fishing wire .	the black dog wearing a red collar shakes water off .
a wet , blond dog carries a stick on the shore .	the wet , brown dog has a stick in his mouth and is running in the sand next to the water .
a dog laying in the snow .	three dogs playing in the snow .
three dogs playing on a beach	a boy standing on a beach .
a man and a woman are riding bikes on a street .	a man and woman are riding bicycles across a junction in the city .
a skateboarder makes a jump off a ramp .	the skateboarder is jumping over a ramp .
a man and a dog on rocks on a beach .	a man and dog on a rocky seashore .
a black and white dog running between poles .	a black-and-white dog running in the water .
a girl with arms raised in sliding down a red and white slide .	a girl with extended arms goes down a slide .
two dogs are playing around in the dirt .	a dancer posing for the camera in a red and white dress .
a woman placing a baby on a skateboard on the beach .	a woman in a brown coat places a baby on a skateboard that is on a wooden runway on the beach .
large group of people standing outside of a building .	a group of people are ice skating in a big city .
a golden dog is running on the grass .	the large beige dog is running through the grass .
the boy in the green and yellow shirt has a glove on and is going towards the ball .	a boy with a bruised nose and writing on his hands is standing in a video rental store .
a dog runs through the grass .	a dog runs across the grass .
a child in a graduation gown throws the cap in the air .	a child rides a bike high in the air .
a black dog is running very fast on a light brown ground .	black dog running very fast .
a man in red shorts is walking along rocks by a river carrying a stick .	a man is walking on rocks with water flowing around them .
man rowing a boat .	a man doing a trick on skateboard
three dogs running on a racetrack .	three dogs round a bend at a racetrack .
a man and child in front of a billboard	a man standing in front of a brick building .
a black and white dog running through an obstacle course	a black and white dog runs through pole obstacles .
two kids laying on a bed upside down	two children are shown upside down .
three little boys standing next to and on a fence .	the three children are standing on and by a fence .
a dog is standing in the sand .	a dog running fast in the sand .
a black and brown dog walks through the snow near a building .	an older man stands outside a old boarded up building .
a person in a yellow shirt and jeans is running on a track .	a woman in a yellow shirt running on a track .
two dogs play with one another on the grass .	two beige dogs play in the grass .
a dog is jumping into a swimming pool after a duck .	a dog jumping into a swimming pool .
two dogs are playing in a grassy field .	two dogs are playing in a field of tall grass .
a black dog is running through the snow .	the german shepherd dog is running through the snow .
a small boy playing in the snow .	two dogs playing in the snow .
people standing outside at a carnival .	two people are standing next to a waterway canal .
a dog running through a forest in the winter time	a dog running through a lot of twigs .
three people stand in an outdoor glass structure .	three people in a glass structure .
two young women walk along a dirt road .	two young women are walking along a rural path bordered by trees .
a boy rides a skateboard with a bike to his right .	a boy is doing tricks with his bike on the ramp .
the girl is playing along with the images on the big screen .	three girls holding umbrellas with their backs to the camera .
many people run in a race on a street .	a puppy running along a street .
two dogs in the snow	two dogs play in the grass .
a man in swimming trunks is standing against some rocks .	a man in a gray shirt climbs a large rock wall .
two white dogs walking in the snow .	a tan dog with a black collar barking in the snow .
two dogs are running in the water while a man watches from the dock .	a dog running through water with a ball in its mouth
a woman wearing a pink shirt jumps in the air with her arms and legs spread to her sides .	a man wearing suspenders and sunglasses leaps up in the air with his arms and legs spread out to the side .
a dog runs through the grass .	two dogs run through the brush .
three dogs playing in the snow .	three dogs run in the snow .
a dog running across the sand	a dog running through the water .
a man in a green hat poses in the mountains	a man travels with two donkeys in the mountains
the boy in the orange shirt is throwing the ball .	the black and white muzzled dog is leaping above the grass .
a man wearing a white helmet is in the water .	a man wearing a helmet , floating in the water .
two dogs play in the snow	a dog plays in the snow .
japanese school girls walk down the street .	people walk along on the street .
a woman is attempting to ride a small wave .	a man and woman sitting back to back outside in the sun .
the black and white dog is swimming in the river .	a black man and his dog on the beach .
a small boy playing in the snow .	a smiling boy with hat playing in the snow .
man standing on top of jagged rocks near the ocean .	a man is standing on top of rocks overlooking the ocean .
a girl in a black and blue wet suit is surfing .	a woman wearing a black and blue striped suit is surfing on a wave .
a lack dog and a brown and white dog run on a gravel surface with something red underfoot .	a brown dog and a black dog are playing with a red frisbee .
a wet black dog walks on the sand with a rock wall behind .	a black dog on a beach carrying a ball in its mouth .
the woman is leading a dog through an obstacle course .	woman leading her small dog through an obstacle course .
several people are sitting around a fire at night .	a group of people sit around a blazing fire at night .
a young child is holding onto the back of a wicker chair .	a young child holds a spoon to it 's mouth while sitting in a chair .
a woman in a park wearing a purple blouse	a women with brown hair is wearing a purple shirt and a white purse .
two dogs are running in the field .	two dogs running in a field .
a little boy wearing boxers is holding a fist up and standing in front of a brick wall .	a man with a jacket wears headphones standing in front of a directory .
two people are in bed .	two boxers are in the ring .
two dogs on the beach .	a dog walks on the beach .
a young boy is standing on a gray tiled area .	a young boy is practicing his karate in a gym .
a dog jumps into the water .	a small dog leaps in the water .
a dog looking at the camera in snow .	a dog is walking in a tire track in the snow .
two dogs fighting in the snow .	two dogs play in the snow .
a person standing in the middle of a bunch of snowy rocks near a waterhole .	a person stands in a vast field of glacial ice .
a group of people are in the water .	a group of people ride in a race
the dog is running with food in his mouth .	the dog is running with a yellow ball in his mouth .
a brown and black dog walks in the white snow .	a brown and black dog walks in the snow with it 's tongue hanging out .
a boy wearing face paint walks along a red track .	a boy with face paint is running on a track .
two dogs running down a beach .	two dogs running on the beach
a black and white dog swimming in the pool	a black and white dog running with something in his mouth .
two dogs are sniffing something in the rocks .	two dogs running down a path in the woods .
a dog has it 's head inside a red and green gift bag .	a pet playfully investigates the contents of a gift bag .
a yellow shirted man wearing a golden sun mask .	a man in a yellow shirt wears a gold , sun-shaped mask .
a little girl is sitting in the grass balancing a rock on her arm .	a little girl walks on a boardwalk with blue domes in the background .
two young children are walking across an open field .	two small children walking in a field .
people on an amusement park ride .	a photo of a ride at an amusement park on an overcast day .
a young boy jumping into a pool that says " no diving " .	a boy jumps into a not-so-crowded public pool .
a man is scalling a sheer rock face with a rope support .	a young man is doing a ski jump with a purple board .
a child with his hands on his head .	a little boy stands with his hands on top of his head
two dogs running in the snow	two dogs standing in snow .
a man wearing a orange vest is canoeing in the blue water .	a man in an orange jacket raising his hands to the sky in the sand .
a woman and a man with a blue shirt are posing for a photograph .	a man and a woman posing for a picture
a black dog lays in the sand .	kids play in the water
there is a squirrel sitting up in the grass .	a squirrel stands in the grass looking around .
a light brown dog runs down a path happily .	a pale dog runs down a path .
the tan dog runs through the leaves .	a tan dog runs in the fall leaves .
an old man in a black trench coat standing in a marketplace .	the baby is wearing a red shirt and walking in a plaza .
a man performs a skateboard trick .	a person jumps off the sidewalk on their skateboard .
a child walking in the snow .	a child in the snow .
a man dressed in black wearing a hat and glasses in front of a red wall .	a woman in a white shirt standing in front of a brick wall .
a bike jumps through the air .	a boy and his bike leaps into the air .
a brown dog is sniffing a white dog that is lying on the floor .	dog sniffing another dog lying under furniture .
a man helps a boy ride a bike .	the man helps the boy ride a bike .
a reddish brown dog runs across the snow with a snowball in its mouth .	the beautiful reddish dog lopes around the flat snowy street with a snowball in its mouth .
a red haired women in black is posing for a man while resting on a tree .	a man in a black shirt is holding a child wearing sunglasses .
a man climbing a cliff face .	a man climbs a sheer cliff face .
a man is going between two red flag markers on a dirt bike .	the man waeribng a helmet is riding a dirt bike over rocks .
the two dogs are playing fetch in the snow .	the dogs play in the snow .
a black dog with a gemmed collar is sitting on white carpet .	a black dog with a blue collar is sitting on beige carpet .
a small black and white dog paddles in some clear blue water .	a black and white dog is swimming in some water
two girls are in pajama pants and appear to be dancing .	two girls with baseball caps are eating a snack outside .
a dog zips along the beach .	two dogs running on the beach .
a white and brown dog playing with a black toy .	a white and brown dog is playing tug-o-war .
two black dogs are jumping and playing with a yellow tennis ball in the snow .	a brown dog and a black dog playing with a yellow soccer ball .
two dogs are playing on the beach together .	two black dogs are playing in a grass .
a boy plays baseball .	a man is playing baseball .
puppy playing with a tennis ball on an orange rug .	a dog is about to get a ball that is on orange carpet .
a black and white dog is jumping over a hurdle .	a white dog running over a bridge .
a boy wearing a red shirt runs across the grass with a furry dog .	a sports fan is wearing face paint in the stands .
the dalmation is running through the woods .	a dog runs in the woods .
a woman waves as she rides a zip line .	a person waving is hanging off a zip line .
a black dog retrieves in the snow .	a skateboarder jumping in the street .
a man rollerblading on a metal bar .	roller blades sliding on a railing .
a smiling man and a baby girl posing for photo .	a smiling man holds a small child wearing pink and red .
two tan and white dogs and one tan dog racing down the beach near the water .	lady in a pink tinkerbell jacket stands next to the railing and looks out at the water .
a brown dog sniffs a tree stump .	a dog sniffs a tree stump .
a dog jumping for a frisbee in the snow .	a dog is jumping in the snow .
five men in blue and black uniforms pose for a picture .	a group of five men in uniform are posing for the camera .
a man is riding a bicycle on a dirt path .	two dogs running along dirt path .
a child jumps in the air at a bowling alley .	a boy in a green shirt is jumping with his arms in the air at the end of a bowling alley .
a brown and white dog with a pink collar is barking at a brown dog with a blue collar in the snow .	the dog with the red collar is bearing it 's teeth at the dog with the blue collar .
two brown dogs runs through the water .	two brown dogs running through water .
a seated young woman in a hat is reading at a coffee shop .	a woman enjoying her reading at a coffee shop
a black and white dog is running through the grass .	the black and white dog is running on the grass .
a man skis on a snowy mountain .	skiiers on a snowy mountain .
two brown dogs are biting each other .	two brown dogs biting each other on sand .
two fluffy dogs run through the grass .	two small dogs run through the grass .
a dog sniffing the brushes while a bull looks on	a brown dog sniffing at the fence of a brown bull .
a skateboarder attempts a trick on the side of a low wall .	a boy does skateboard tricks on a railing .
the small boy is sliding down a pool slide and is about to hit the water .	a small boy in waterwings and a bathing suit slides down a water slide .
a seated woman with short hair and a camera throws a frisbee to a brown dog .	a woman who is sitting in a field listening to music throws a frisbree for her brown dog .
a young girl doing a back flip in the water .	a young girl wearing purple running through water
a snowboarder rides a snowboard down a railing beside a flight of steps .	a boy is grinding a skateboard down a concrete wall .
three greyhounds racing on a track	five greyhounds are racing on a sand track .
a black dog is jumping out of water .	a black dog is shaking off water .
a dog is jumping in the air trying to catch a red frisbee .	a dog is jumping in the air to catch an item .
a brown dog is walking in the water .	two brown dogs running through water .
a woman with two men in hats socializing outside .	a young woman with a knit cap stands against the wall of a domino 's pizza .
a small boy in a bathrobe is sitting in a metal chair .	a boy in a robe sits in a chair .
a dog shakes off water	a dog shakes his head .
people sitting on a couch laugh .	four happy people sitting on a red couch
a black dog is running through the snow .	a black pit bull dog is running through the dirt .
a group of teenagers are dancing on a wooden floor .	a group of people in dark colored clothing are line dancing on a wooden floor .
the man sits on a sofa under the bridge and litter is all around him .	a man is sitting on a couch under an expressway ledge .
a white dog is running through the snow .	a little white dog running through the sand .
a woman stands with her arms out at her sides while another takes a picture .	a man stands in a crowd holding a white object .
a young boy is riding a bike .	a young girl laying on a blue inflatable toy
a black dog running in the snow .	a black dog running on a beach .
three dogs in the snow by a fence .	two dogs drink water in a lake .
a brown dog playing play wrestling with a black dog on snow covered land .	two dogs playing on snow covered ground
a dog runs through the deep snow .	a white dog is running through the snow .
a girl runs along a river bank with two black dogs .	a little boy is petting a tiger that is laying down .
a person skateboarding at a skate park .	person snowboarding at a ski slope .
a brown and white dog is running across the grass .	two brown and white dogs running across grass .
a man climbing a rock-face .	a man is climbing a rock wall .
a teenage girl running on a beach shouting , with an older man walking behind her .	a young child running along the shore at a beach
woman playing tennis and hitting the ball .	a woman is playing volley ball .
a black dog leaping over a hurdle .	a small dog jumping over hurdles .
two dogs are running on the grass .	two birds interacting in the grass
a young boy with his hair standing up , is sliding down a blue slide	the kid in the orange shirt is sliding down a teal slide .
many people are on the beach , near a building with flags flying .	a busy beach has people scattered on it watching the sky .
a dog standing in the water .	a girl playing on a parachute .
a man in a black jacket is holding a microphone toward a young girl with long brown hair .	a man in a black jacket holds a microphone up to a girl 's face .
a brown and white dog is walking next to a man on a skateboard .	a blond child is laying on a branch of a tree in a green field .
man riding a surfboard on a wave .	a man in black on a surfboard riding a wave .
a surfer is riding on a breaking wave .	a group of surfers catching a wave
the man in the red shirt is climbing the side of a mountain .	a man is climbing the side of a mountain .
black and white dog running through water .	a tan and white dog runs through water .
a little girl in a colorful dress is playing with a blue and red soccer ball .	a little girl in a dress playing with a soccer ball .
a black and white dog jumping high to catch a ball .	two black and white dogs run across a green field .
a black and white dog is chasing a ping frisbee .	a black and white dog is looking at a pink frisbee on a court .
a man riding a motorcycle while wearing a black uniform .	a white motorcycle is being ridden around a race track .
three children playing on rocks near a lake	three men playing baseball .
a brown dog is running through water with a stick in its mouth .	two dogs playing with a stick in the water .
brown dog with mouth open and ears in air running .	a grey dog with short hair running toward the camera .
a women and a dog playing outside	a woman plays with her rottweiler dog outside .
three clowns in bright , multi-colored costumes .	three women in brightly colored dresses .
a black dog swimming through a river .	a black dog digging through the snow .
a brown dog jumps high on a field of grass .	a brown dog running in field of long green grass .
two beige dogs play in the grass .	two tan dogs play in the grass
two dogs are running through the grass near a house and trees .	two dogs are running through a green yard
the brown and white dog is running across the sand with a red object in his mouth .	a dog is running along a beach with a red object in its mouth .
a man and a woman are smiling .	a man and a woman laughing .
a man is standing on top of a rock or mountain watching the sun set .	a man standing in the mountains watching a sunset .
a brown and white pitbull runs through the grass with a stick in it 's mouth .	a dog runs through the water while holding a stick in its mouth .
two little girls are playing on a trampoline .	two little boys are playing on a playground .
a black and white dog jumping into the air .	a black and white dog jumping to catch a ball .
two girls are jumping high in the air .	two dogs nussle one another in the grass near a lake .
the woman holding a black purse is smoking a cigarette .	a woman with a black bag is smoking a cigarette
a small boy wearing a diaper stands near the door and is covered in marker .	a young boy covered in ink stands in front of a white door .
a dog is running along the grass .	a brown dog is running in the grass .
a man with long hair is looking through a camera .	a woman stands against a wall near a video camera .
a dog and a red ball in the air .	a dog digs a hole in a yard .
a tan dog runs through the snow .	a black dog running through the snow .
a brown and white dog is running across a brown field .	a person hanging from a rocky cliff .
brown dog running on grass .	the dog is running on grass .
a dog jogs through the grass .	a dog trots through the grass .
a woman stands on a wall to pet an elephant .	a man is riding an elephant while another person is touching the elephant 's head .
a white , fluffy dog is standing on its hind legs .	a man is walking behind a dog that is standing on it 's hind legs .
two people wearing hats sit and look at the camera .	a man wearing a blue shirt makes a grouchy face .
a dog lies at the front of a boat headed into the fog .	a man helps another man do a back flip in a yard .
a skateboarder doing a trick on a ramp	a skateboarder riding up to a slope .
a black dog standing in the grass near a volleyball .	a brown and black down with a blue collar near a soccer ball on a grassy field .
a man water skis while attached to a parachute .	a man kite surfing creates a wave .
a brown puppy chewing on a stick .	a puppy with big ears chewing on a stick .
a dog with its two front paws on a rock in a field .	a dog is running in a field .
two girls playing with people and flowers behind them .	two young girls wearing skirts are playing in a garden .
a woman plays a video boxing game on a big screen .	a woman in jeans plays a video game in front of a large screen .
a man dressed in denim is walking along a snow covered street next to red brick buildings .	a man in blue walks down a snowy street next to a brick building .
a dog jumps through a black hulahoop .	a trainer runs next to his dog as it jumps through multiple hoops .
a surfer catching a big wave in the ocean .	a man is surfing a large wave in the ocean .
a man in a white shirt is dancing with a woman in black .	a man in a white print shirt and a woman in a black dress dancing .
a girl in a pink shirt is sprawling her limbs out in midair .	a man dressed in a santa suit is climbing up a large concrete building .
a little girl in a red shirt pulls a kite .	a girl in a red shirt takes a picture on a phone .
a dog runs with a yellow toy in its mouth .	a dog swimming with a stick in it 's mouth .
child sliding in the snow .	man sleeping on the street .
the black dog plays in the snow .	a black poodle is playing with the snow .
a white dog with brown ears is running on the sidewalk .	a white dog with brown spots is running in a yard , chasing a ball .
three dogs are playing in the water .	three dogs swim in the water .
a white dog running on sand .	a white dog runs on the sand .
a little girl with her hands in the air is sitting on a man 's back while he is laying on a blanket .	a kid runs in the opposite direction of others who were playing a game .
a woman in costume is playing a bagpipe .	a lady wearing a red dress is playing a bag pipe .
a group of people having their picture taken .	a group of people are in the water .
a red and white race car racing on a dirt racetrack .	a person is riding a dirt bike in a race on a dirt track .
a black and white dog is running through a cow field .	a large black and white dog runs in the ocean water
a white dog with light brown markings has a stick in his mouth and his paws in the snow .	a white dog holds a stick in its mouth while it runs through snow .
a man in a straw hat shades his phone while others walk on a busy sidewalk .	a man lies on a street with his headand shoulders under a parked car that is jacked up .
a man with a messenger bag in front of a gray tile wall .	man in red jacket standing in front of lighthouse .
the dogs are walking in the desert .	three dogs playing in the green water .
a dog swims in the water .	three dogs swim in the water .
group of little girls and a dog standing on the road .	a group of people white water rafting in a blue raft .
a little white curly haired dog runs across the pavement with a stick in its mouth .	a white curly haired dog runs with a stick in it 's mouth .
a man in a wet suit is throwing a baby wearing a wet suit up into the air .	a man in a white print shirt and a woman in a black dress dancing .
a man in a grey suit kneels in front of a woman in a white dress .	a woman in red with a beer followed by a man in white .
two large brown dogs are both grabbing a black frisbee .	two brown dogs are biting on a black frisbee .
the blonde woman is wearing a black , american flag , tartan cap .	a red-haired woman is wearing a black beret adorned with the american flag .
a person holding a net is standing in the water .	a black woman and two black children are sitting in a thatched tent .
a woman in an red tracksuit squeezing lemons in a press .	a young woman in a pink hoodie takes a picture .
two dogs play in the grass .	two dogs play in the water .
a black and white dog is running through the grass .	a tan dog is walking through snow .
a woman walks with a book while talking on a cell phone .	a woman wearing a blue coat walks and talks on her cellphone .
a man walks two dogs on leashes down the street	a man walks two dogs in the city .
a brown and white dog with a pink frisbee in it 's mouth is humping over a man 's back .	a dog with a frisbee in its mouth , jumps over a man .
an adult male wearing a backpack walks and looks to the left .	a man wearing a backpack looking to the side .
a dog is running in the snow .	two dogs running in the dirt
a small boy playing in the snow .	the brown and white dog is playing in the snow .
two dogs play in the grass .	two dogs run through the grass .
the dog is jumping in the air .	a soaked dog is playing in the water .
two children jumping into a body of water .	two people diving into a body of water .
a harnessed dog leaps over a log as another dog follows behind .	a brown and white dog is leaping over a log in a field while another dog follows behind it .
several people sitting at small tables in a darkened room .	people are sitting at square tables in a red room .
a dog and cat laying down together .	two grey dogs are carrying a stick in the water .
this is a boat on the water with mountains in the background .	a white boat on glassy water with mountains in the background .
a dog is playing in water .	a dog shaking water off .
a woman in a blue shirt and tan shorts sits at a table .	a smiling young woman in a tourquoise shirt and bandanna poses at table outdoors .
a family is playing on the beach with their dog .	a naked little girl being thrown into the air .
a dog running through deep snow pack .	a dog runs through the deep snow .
three young girls dance on the beach in the sand .	three children playing in sand at beach
two dogs playing together in the snow .	two dogs play together in the yard .
a man in a blue shirt holding a camera .	a man in a blue shirt smoking a cigarette .
people with numbers on their chests are running in a pack .	a group of people are running a race .
a white dog running in the snow	the dogs are running in the snow .
a dog runs through the long grass .	a dog lays down in the long green grass .
the black dog is running through the snow .	a race car driver is driving his car through the mud .
a dog wearing a green sweater and a backpack walking on snow .	a small dog wearing a green sweater and a backpack walks through snow .
a group of people sitting around a desk .	a group of girls on a beach .
the brown dog is running through the grass with a yellow toy in it 's mouth .	a tan dog running through the grass with a toy in his mouth .
three dogs are running in a field .	two dogs are running in a grassy field
a man and woman with their hands on their chins are standing next to a christmas tree .	the man with a white beard and blue cap is standing in the doorway of a workshop .
the black and white dog has a stick in his paws .	a black dog and a white dog are standing on snow .
a white dog running through the snow	the black and white dog runs through the grass .
a black and brown dog is running across a muddy field .	a lone dog running in a dirty road
a man is riding a kayak through water .	a man kayaks in rough water .
a man on skis on a snow-covered hill with mountains in the background	a dog enjoys a romp in the water with mountains and sand in the background .
a man in black shaving a ice sculpture .	a man has a chainsaw and is carving a block of ice .
little boy with blue shirt crawls across vents near large glass windows .	a small boy in blue crawls along a window sill .
a pale tan dog is carrying a stick in its mouth outside .	a small dog is carrying a stick in his mouth .
a group of people are camping out on some rocks .	a group of people are standing beside a fire truck .
a black and white dog jumping high to catch a ball .	a black and white dog is jumping over a hurdle .
a black dog is playing in water with a green toy .	a black and white dog is playing with a tan dog .
three brown dogs are playing in the sea .	three brown dogs are in the water .
four small children sit on tall stools at a resturaunt bar .	four children sit on tall bar stools at a yellow and grey bar .
a man on a bike nest to a river .	a man on a bike does a very high jump .
three dogs on grass running towards the camera .	the two dogs are running toward the camera .
a brown dog playing outside with a pink ball .	brown dog catches a pink ball in the park .
two young men are juggling multi-colored blocks with people watching .	two men stand juggling colored boxes while other men stand on a balcony .
a dog nipping at the feet of a cow .	a brown dog running after a young cow .
a dog running on the grass	two dogs are running on the grass .
a brown dog runs near the water .	two brown dogs runs through the water .
there is a black dog jumping into a swimming pool .	a black dog is leaping into a swimming pool .
a boy receives a light saber for christmas .	a boy holds a light saber in front of a christmas tree .
a skier going down the snowy hill .	a brown dog is laying in the snow .
two dogs are running on the grass .	two dogs running in the dirt
two black dogs are playing tug-of-war with an orange toy .	two dogs are playing tug of war with a green toy .
a man is spraying a fluid from a long hose at the beach .	a guy is sitting on his bike with one wheel in the air .
three dogs playing in the snow while one dog wears a jacket .	three dogs playing in the snow , with a city in the background .
many football players sitting on the ground .	a dog rolls on the ground .
a group of people in boats racing towards the shore .	a group of people stand together and pose in front of a house .
a little boy and a little girl playing together outside .	a woman wearing a white shirt stands on the street .
a person in a red vest is touching the blue ice skates on another person .	a lady fastens someone 's ice skates in the snow .
a golden dog plays in the snow	three dogs playing in the snow .
a man wearing glasses stands in front of a snowy mountain .	a man wearing black shorts is standing in front of a snow covered mountain .
a girl bounces upside down on her head on a trampoline .	a girl is bouncing on her head on a trampoline .
the surfer does a flip off of a wave .	a surfer does a flip on a wave .
a man is holding a very long leash attached to a very large dog who is smelling the grass .	a man holds a long leash with a large gray dog attached to it .
people travel up the elevator together .	people go up the escalator .
a brown dog standing in the middle of ahuge field .	a brown dog in a field .
two children are playing in a green boat on the grass .	two children are playing flag football together .
a female dj holds up a michael jackson album .	a girl holding a picture of michael jackson smiling
two males , one in red and one in white playing a basketball game .	a man with jersey 23 is dunking the ball at a basket ball game .
a woman standing in front of trees and smiling .	a man is walking by trees in front of the city skyline .
two dogs are playing in the snow .	a dog playing in the snow .
a man wearing a blue shirt crouches on a rocky cliff .	a man sits on a rock .
a white dog with an orange spot jumping through dried grass .	a dog is running through reeds towards the ocean .
a black and white dog jumps to get the frisbee .	a black and white dog jumps after a yellow toy .
a black dog jumps in the snow .	a black dog jumping over tire tracks in the snow .
a boy doing a back flip into a swimming pool .	a boy wearing red and blue swim trunks jumping head first into a swimming pool .
three little boys cover themselves with bubbles .	three children standing by a pool are covered in foam bubbles .
the boy is looking up at the girl as another girl ignores them .	the boy is diving into the pool as the couple watch .
two white standard poodles play with a toy in the snow	two dogs fighting in the snow .
a crowd of people stand on a rural road , a field behind them , a forest in front .	a bunch of people standing next to a car with it 's trunk open .
boy lies on stomach in grass .	small boy lying on his stomach on the grass .
a man is jumping over a low wall holding a bicycle .	a man walks over a small sign carrying his bicycle .
a black dog is swimming with a ball in it 's mouth .	a white dog is standing on it 's hind legs with a ball in it 's mouth .
a black dog with a blue collar is running in the snow .	a black dog with a red collar plays in the snow .
a japanese swordsman jumps into the air .	a woman is getting her dog to jump in the air .
a boy wearing a yellow shirt and blue pants is climbing a tree in a hilly area .	a boy wearing a yellow shirt and blue pants is climbing on a tree branch in a grassy field .
two dogs play by a tree .	a dog chases another by a tree .
a bird sits in a tree .	a bird sits in a leafless tree .
a brown dog chews on an orange ball .	a dog has an orange ball in its mouth .
a hiker with a backpack is up on a misty mountain top .	a hiker climbing a rocky hill with fog surrounding him .
a man and woman sit on a car and watch the road .	a man and woman sitting on a parked car .
a man with a dark brown shirt is climbing up a rocky elevation .	a man is climbing a rocky mountain .
two boys wearing matching blue swim caps swim in a lake .	young boys wading in blue swim caps .
a white dog runs along a rocky shoreline .	a dog jumps over a hurdle .
three boys leaping in to a swimming pool .	three happy boys wearing blue bathing suits hold hands as they jump into an outdoors swimming pool .
a brown dog jumping into the air to catch a ball .	three young woman jumping into the air to catch a ball .
boy doing tricks on a skateboard	a man doing a trick on a skateboard .
a brown and white horse runs quickly .	a brown and white dog is running around a pole .
the brown and white dog is in the water .	the brown and white dog is playing in the snow .
a child is walking from one picnic table to another .	the boy hops from one picnic table to the other in the park .
a man wearing us flag boxer shorts is standing on a stairway .	a woman wearing a white shirt stands on the street .
a group of seven people are rafting in the rapids in a green boat .	a group of people are standing and sitting around on the ground at night .
a dog in the snow .	two dogs in snow .
a man with long hair is looking through a camera .	a man with sunglasses looking straight ahead .
dalmation running along the beach .	a dalmation runs along a beach .
a man climbs a snowy mountain .	a hiker moves up a snowy mountain .
a black and white dog jumping in the air to catch a frisbee	a black and white dog jumping in a yard .
the woman is holding the harness that the brown and white dog is wearing .	a man and woman are looking at artwork that is on easels and clipped to a fencing wall .
a brown and white dog runs with a tennis ball in its mouth .	a black and brown dog is running with a tennis ball in its mouth .
a dog running through snow .	a dog runs in the snow .
a person wearing jeans sits on top of a horse saddle .	the girl is sitting on top of a saddle .
a soccer player in a red uniform just kicked a ball .	a goalie in a red uniform kicks at the soccer ball to protect the goal .
four black dogs run across the grass .	a dog runs across the grassy field .
a man in red and black is hitting a soccer ball with his head .	a man in a red striped soccer shirt heads a ball .
a brown dog is walking on the grass .	a dog chases another by a tree .
a yellow dog in the snow .	two dog play in the snow .
a girl is jumping .	a boy is rock climbing .
a dog carries a stick through the woods .	a dirty dogs runs through the woods .
a dog runs through the grass .	a dog runs through an obstacle course .
a boy wearing a yellow shirt and blue pants is climbing on a tree branch in a grassy field .	a blond-haired boy wearing a yellow shirt and blue pants is climbing a large , fallen tree limb outdoors in grassy meadow .
two men are racing in the water .	two young boys playing with ducks near the water .
brown dog chases after yellow ball in park	two brown dogs chase each other in the snow .
a woman placing a baby on a skateboard on the beach .	a woman holds a small baby on a skateboard at the beach
two black and white dogs running in a field .	a black and white dog jumping into a swimming pool .
a black dog is biting a light brown dogs ear in a playful manner .	a black dog playfully bits another dog in a living room setting
the beagle is walking on the beach at the waterline .	a beagle walks along the calm shore .
a young pitcher is throwing the baseball .	a brown dog is walking on the grass beside a fence .
a person in mid air on a yellow motorcycle .	a cyclist on a neon yellow bike is airborne .
a young girl slides down a green plastic slide on a playground .	a little girl sliding down a slide at a playground .
a kid turns around with an object in hand while someone passes behind him .	a boy crawls through a rock tunnel with his brother and father behind him .
the black and white dog runs through the grass .	a black and white dog is running through grass .
small black dog running in grass	two dogs running in grass
a girl is doing a trick on her trampoline .	a girl does a handstand on a trampoline .
two dogs run through the snow , one with a tennis ball .	the boy is doing a stunt , through the air , on his bicycle .
two dogs run towards shore through shallow water .	two grey dogs running through the shallow water of a lake .
a black dog is walking on the grass with a stick in it 's mouth .	the black dog is running on the grass with a toy in it 's mouth .
kids playing tag football .	young boys play touch football .
three children playing in snow .	three children playing in hay
a man walks toward a policeman standing in a crosswalk on a city street .	a policeman stands in a crosswalk in a city .
a young boy is spinning around a baseball bat on the grass .	a young boy holds his head to a baseball bat on the green grass .
two people ride their bikes down a dirt road .	two people riding their bikes on a hill .
the black and brown dog is playing in the yard .	the black and tan dog is chasing something he has spotted .
a black dog in the grass is holding a bird in his mouth .	a black dog is holding a black bird in his mouth .
a black dog and a white dog playing in the street .	a black dog and a white dog play in the street together .
a man in a black shirt swims next to a girl on a pink surf board .	a man swimming beside a girl on a pink body board .
a young boy in a blue jacket swings a bat at a ball .	a young boy wearing a blue visor swings a bat .
a large black and white dog is swimming in the water .	a black and white dog with a stick is in muddy water .
a little boy clowns with a colander on his head .	a boy with a metal colander on his head .
a brown dog is running through the field .	a brown dog with his tongue wagging as he runs through a field
a skier skiing down a large mountain	a person skiing down a very large snow covered mountain .
a dog jogs through the grass .	a dog sprints across the grass .
a boy is blowing bubbles	a boy in blue is blowing bubbles .
a man is holding a bus pole in front of a building .	three pole wait for a bus outside a building .
a boy is jumping into the water with a ball in his hand .	a little boy swimming underwater with a toy in his hand .
two boys show off their stained , blue tongues .	two boys with wearing baseball caps are sticking out green stained tongues .
a person wearing scuba gear is swimming underwater water .	a person is scuba diving in very clear blue water .
a white and black dog runs on the grass .	black and white dog running outside .
two men stand on a cliff top overlooking a sandy beach .	a man stands on a cliff overlooking the ocean .
this dog is jumping through the water .	two dogs running through the water on a beach .
a male baby makes a funny face for the camera .	children smiling and making faces to the camera .
two constructions workers sit on a beam taking a break .	the man is putting on his shirt near an elevator .
a man and a woman laughing .	a man and a woman kiss .
a little boy is in a tire	a child rolls around in a large tire .
a black , brown and white dog running through a field .	a white and brown dog runs in a field .
two dogs run on the grass .	a dog running on the grass .
children are playing in a swimming pool while two adult men watch them .	children play in a pool while adults look on .
the football players are working on stretching their legs .	football players are stretching together .
a dog is standing in the sand .	a tan dog is standing in front of some plants .
four girls in swimsuits are playing volleyball at the beach .	four ladies in swimsuits play sand volleyball on the beach .
two children are on a fairground ride .	two children are on a giant inflatable slide .
two kids splashing in the water .	two dogs play together on the bed .
brown and white dog with a baseball in its mouth .	black and white dog holding a baseball in mouth .
a tan dog runs through the snow .	a white dog is running through the snow .
a blonde haired toddler swinging on a tire swing .	a blonde haired child is swinging on a tire swing .
the brown and white dog is walking in shallow waters .	a white and brown dog appears to be walking on the water .
a woman reads while on public transportation .	a man who has fallen asleep on public transportation .
two dogs are fighting on brick pavement .	two brownish dogs are fighting .
a bulldog is running through a grassy park while people stand in the background .	a dog is running in a large body of water causing it to splash .
a young boy riding a bike on a brick road	a person does tricks on a bike on a ramp surrounded by trees .
a brown dog and a tan dog are playing in tall grass .	a black and brown dog with a red ball overhead plays in the grass .
a man asleep on a yellow striped bench with his feet on a baggage cart .	a man in jeans resting on a striped bench with his feet on a luggage cart
the black and white dog is running on the grass .	this large black and white dog is running on the sand .
two boxers with white gloves are fighting .	two men with white gloves box in a dimly lit boxing rink .
a skateboarder high in the air above an indoor ramp .	a skateboarder in mid-air above an indoor ramp .
the black dog is running through the water .	the black and white dog is running through the bushes .
the black and white dog is running on the grass .	the white dog is running in the green grass .
the young man is skateboarding at a skate park .	a boy in a blue t shirt is airborne on a skateboard in a skate park .
a woman having her picture taken in front of a large carving .	a woman poses for pictures with a statue of a troll .
a brown and white dog is walking next to a man on a skateboard .	a brown and white dog is running down a ramp .
a brown dog jumps high in the grass .	a brown dog digs in the sand .
a brown dog running over grass .	a brown dog running
a girl jumping rope on a sidewalk near a parking garage .	a girl jumping rope on a sidewalk with a parking garage to the left .
two dogs run on the beach .	brown dog running on the beach .
a person is out in the water at the beach while the sun sets .	a person above their surfboard on the water .
a skateboarder in the city .	a skateboarder on a ramp .
a dog jumps in midair to catch a frisbee .	the brown dog jumps for a pink frisbee .
a child wearing blue and white shorts is jumping in the surf .	a girl wearing green twists something in her hands .
three dogs running through a puddle .	the dogs are running through the yard .
the dog returns the play toy to its master .	three dogs race in the snow together .
two older people sit at an outdoor cafe table .	three people sit at an outdoor cafe .
a woman wearing a plaid skirt stands holding a cigarette .	a man in a blue shirt is standing outside smoking a cigarette .
two females jump off of swings .	two girls jump out of swings .
a woman with a young girl pose with bear statues in front of a store .	a man in a jersey stands in front of a large crowd .
a person wearing pink pants and a white parka at a snow park .	a person wearing pink pants and a white jacket is snowboarding .
two dogs running on the shore .	a white dog running on the beach .
two dogs run on a dirt area near a forest .	two dogs run down a dirt path in the forest .
the white dog has a ball in its mouth .	the black and white dog has a ball in its mouth .
a man in a red shirt rappelling down a waterfall with a red rope .	a man in red is climbing a waterfall with a red rope .
a brown dog runs through the water in the ocean .	a brown dog runs through the water as a wave comes .
a girl wearing a green jacket is standing at a stop light .	a woman in a green jacket is waiting to cross the street at a light .
a shirtless man playing football on a lawn .	a shirtless man catches a football
a girl wearing green twists something in her hands .	a young boy wearing only green shorts poses awkwardly with a brick background .
a young girl smiling with her head upside down	a girl poses with her head upside down .
two women holding checkered flags near an orange car .	two ladies in skimpy clothes pose next to an old fashioned car .
a young man with a beard at an event .	a dog stands on a beach at sunset .
a man in a red jacket holds his bike for the picture .	a woman in a red jacket is video taping a natural landscape .
a boy jumps into a not-so-crowded public pool .	a man jumps while on a snowboard .
a boy plays in the fountains .	a young boy plays in the water fountain .
two boys play swords in the grass with rods .	two boys play with large sticks in the yard .
the clowns are striking a pose for the camera .	a child in orange is on a boogie board in the waves .
a black dog walking along a rocky terrain .	a black dog walks through a rocky , grassy landscape under a blue , cloudy sky .
four kids holding hands jump into a swimming pool .	four dogs playing in the snow .
two brown dogs barking at each other .	two brown and black dogs growling at each other .
a black dog jumping into a lake .	a black dog runs very fast in a field in a park .
a child playing in water .	a child in water .
a yellow car speeds along a snowy field .	a yellow car drives quickly in the snow .
the black dog is running on the grass .	the german shepherd dog is running through the snow .
a boy pushes a wagon with two pumpkins .	a child squats behind a wagon with two pumpkins in it .
two soccer players battle for the ball during an intense match .	two little orange and white dogs are in the snow .
a person swimming in water nearby rocks and a small waterfall .	a person floats in water near rocks and a waterfall .
two boys in a field kicking a soccer ball .	two football players bang into each other during a football game .
two people run in the sand at the beach .	people running away from seagulls on the beach .
a white dog runs by pine trees in the snow .	a dog stands in the white snow .
a white dog runs through a field of yellow flowers .	a dog runs through a grassy field of yellow flowers .
the black dog is walking through the tall grass .	the black dog is running through the grass .
two dogs playing in snow .	two dogs playing in grass .
one boy is pushing another boy on a swing .	a boy is pushing another boy on the swings .
a pitcher on a mound throws a baseball .	a boy in the middle of a pitch at a baseball game .
two little girls playing on the parallel bars .	the little girl is playing at the playground .
two black dogs playing in the snow .	a black dog digs in the snow .
a white and tan dog runs through the tall green grass .	a medium sized brown and white streaked dog is running through tall grass .
a brown & white greyhound dog sniffs the snow .	a black and white dog jumps in the snow .
two dogs play in shallow water .	two dogs play in the water .
a girl wearing a pink coat splashes in rain puddles .	a girl in a pink jacket is walking through a large puddle .
a dog jumps over a chain .	a dog leaping over a chain .
a man stands in front of snow covered mountains .	a man skiing down a snow covered mountain .
little girl and older male , holding hands and walking on train tracks .	the little girl in the blue dress is walking with a man along a railway track .
a black and grey dog runs in a field with it 's tongue hanging out .	a black dog with a red collar walks through the grass with his mouth open and tongue hanging out .
a girl with a black purse sitting on a wooden bench .	a young woman with a black purse sits on a wooden bench .
the dog is running in the grass .	a dog pounces on the grass .
a boy in a red shirt , in front of a long blue wall , raises his eyebrow at the camera	the boy in the red shirt is next to a blue wall .
the kid is sliding down a tan plastic slide .	the boy is sliding down a metal slide .
a black and a yellow dog	a black dog and a brown-and-white dog play in a field .
three children in a ball pit .	several children playing in a ball pit .
a large white and grey dog runs through a yellow tunnel in an obstacle course .	a white and black dog is running out of a yellow and orange tube .
a black and white dog is swimming in a large green lake .	a black and white dog is swimming in a lake .
a swimmer is doing the backstroke in the swimming pool .	a person doing the back stroke in a swimming pool
the white and brown dog is running through the grass .	the brown dog is running on the grass .
a man stands astride a bike on a rocky trail by a lake .	a woman is wearing a white headband , purple tank top and black gloves .
a brown dog is running through green grass .	a brown dog is running though a river .
a motorcyclist " pops a wheelie " in a grassy field framed by rolling hills .	a man on a motorcycle pops a wheelie in the dirt .
a little boy is kicking up his feet in the water .	a boy in shorts kicks while standing in shallow water .
a small white dog and large brown dog play on the grass .	a small light tan dog is running past a large brown dog standing in the grass .
young boy wearing a denim shirt sticks out his tongue .	a young boy wearing a denim jacket sticks his tongue out .
a woman holds a dog while another dog stands nearby in a field .	a lady holding one dog while another dog is playing in the yard .
a light brown dog is running in the water .	a brown and white dog running into the water
a little girl is riding a toy tricycle on springs .	a little girl is playing on a toy outdoors .
a young boy is running a race .	a boy runs in a race while onlookers watch .
the girl in a pink coat and pink boods is wading through a puddle .	a girl in a pink jacket is walking through a large puddle .
a black dog walking through water .	two black dogs walking through the snow .
a dog leaps out of the water towards shore .	a tan dog jumping through the water towards the shore .
a black dog is running in snow .	a black dog is swimming with a ball in it 's mouth .
a woman dressed in green is playing with her tan dog .	a tan dog licks a girls hand while laying down .
two homeless men stand outside with a cardboard sign .	two homeless young men holding a cardboard sign .
a woman is sitting in the water .	the woman is skating in the park .
a brown dog wades in the water .	a dog splashes in the murky water .
a tan girl in a floral bikini is swimming in dark blue waters .	a little girl in a flowered bathingsuit runs through the sand at the beach
one man in an orange shirt wearing a white helmet is riding a bike .	the man wearing a blue helmet is riding a polaris .
a hockey player looks intently downward .	a hockey player during a game .
a boy in a red jacket and balck hat sliding on his knees down a snowy hill	a boy is riding a red sledge down a snowy hill .
a black and brown dog plays with a long stick .	a dog gets its legs tangled with a stick .
a black and white dog leaps to catch an orange frisbee .	a black and white dog prepares to catch a frisbee .
a little boy is standing in front of a wedding party laughing .	a person standing on a stage in front of a seated crowd
two brown dogs chase each other in the snow .	two brown dogs are playing with each other in the snow .
a tan and white dog walks in the sand on a nice day .	a black and white dog jumps in the air near a red frisbee .
a surfer is riding on a breaking wave .	a surfer is riding a large wave .
a person on a snowmobile .	a person on a snowmobile in mid jump .
a small dog runs through a field .	two dogs run through a field .
children are playing on a trampoline in the snow .	several children and jumping on a trampoline in the snow .
the man is standing on the shore hitting a ball with a paddle .	two teenage girls are standing on beside the beach listening to ipods .
a black dog is playing in the snow .	a big black dog bares its teeth while running through the snow .
this over the top photo shows two men taking a break .	a person with swim cap and goggles taking a breath .
the woman walking is wearing a skirt and boots .	a woman in a short skirt and boots .
a boy holding a large foam wand waves it near a swimming pool .	a boy plays with a foam noodle toy by a pool .
two brown dogs running together on sand	two brown dogs are running on the sand .
a young blonde child holding an airplane .	a young blonde boy holding a toy airplane .
two gray dogs run together over the green grass .	two dogs playing together on the grass .
a white dog with black markings runs through the snow .	two large black dogs run through the snow .
a black dog is chasing after a red frisbee .	a black poodle is running in the snow .
a girl blows on a dandelion .	a blond gear with a pink shirt is blowing on a dandelion .
two girls with ponytails ride an amusement park ride .	a young girl is on a ride at an amusement park .
a dog digging in the sand .	a brown dog digs in the sand .
person on a polaris ski mobile in the snow .	people riding something in the snow .
a grey dog swimming through a river with a stick in his mouth	dog swimming through water carrying stick in its mouth
the dog is running through deep snow .	a dog running through snow .
a dog is jumping in the air to catch an orange frisbee .	a white dog jumping in the air to catch a red frisbee .
a woman in a blue bathing suit is jumping off a dock into a lake .	a boy in a blue shirt and blue jeans runs across a playground
a brown dog leaping from a dock into the water .	a tan dog leaps into the water .
two men sit on the sidewalk in front of stores .	a woman in a bathing suit walks a dog on the beach .
a black and white spotted dog jumps over a stream .	a black and white spotted dog is jumping over the small stream of water .
a woman in a green costume is standing in front of a topless woman with painted breasts .	a person in a green feathered costume is bending down in front of a woman with painted breasts .
a basketball player holding a basketball .	a basketball player is scoring a basket .
two children are walking on a sidewalk wearing yellow and red backpacks .	two children are walking along a street wearing yellow backpacks .
a person on a bmx bike .	a man on a bike in mid-air
two dogs running through tall grass .	two dogs are running through a grassy area .
little white dog wearing a leash jumping after a red ball .	a black and white dog returns a stick in the snow .
a black and white dog jumping into the air .	a black and white dog jumping over an obstacle .
a group of women wearing bikinis are playing beach volley ball .	four young women wearing bikinis are playing beach volley ball
a group of people standing outside of a building .	a large group of people have formed a line outside .
a dog with a stick follows another dog through the water .	a four wheel drive car is driving through the mud .
a group of four children dancing in a backyard .	a group of children do stretches on colored mats .
two black dogs are playing on the grass .	two black dogs are playing in a grassy plain .
a group of teenagers are jumping in the air on the beach .	a group of young people jump up in the air while on the beach .
a black and brown dog is chewing on a large stick .	a black and white dog playing in the sand .
two dogs are playing in the snow .	the dogs are running in the snow .
a boy waves around a sparkler .	a young boy is twisting a sparkler around in the air .
a young girl is diving into a pile of brown leaves in the yard .	a girl is jumping into a pile of leaves .
a woman wearing a pink tinker bell jacket leans against a railing .	a woman wearing a pink tinkerbell sweatshirt leans on a railing overlooking water .
two black dogs playing in the grass .	two dogs play in the grass .
two white dogs running in the grass together .	two dogs run and play with a brown stick .
several people are sitting around a fire at night .	a group of people are standing and sitting around on the ground at night .
two boys are jumping into a pool .	two boys are in midair jumping into an inground pool .
two different breeds of brown and white dogs play on the beach .	two dogs playing in the sand at the beach .
a man plays a guitar for a sick child in a hospital	a man is playing a guitar for a little girl in a hospital .
one man and two women dressed in vampire costumes	a man and two women dressed in costumes .
two dogs are bearing their teeth at each other .	two dogs stand in water and bite each other 's mouths .
a brown dog is running across the snowy ground .	a greyish dog running in the snow .
two boys , one wearing a hat , in a playground .	boy in tan hat laughs while sitting near playground equipment .
a woman jogs beside a tall concrete wall .	a woman runs beside a concrete wall .
some football players in red jerseys taking another in a white jersey to the ground	three football players from red team tackling one player from white team .
a dog is running through the snow .	a brown dog is running through the field .
two dogs playing in snow .	two dogs play in the snow .
bicyclists are standing at an intersection .	bicyclists waiting at an intersection .
a woman holds a baby while a man looks at it as another man holding a child watches .	a woman stands with her arms out in a store while another woman holds a camera .
a white fluffy dog is running in pure white snow .	a fluffy , white dog running in the snow .
a woman holding a newspaper .	a man rollerblading on a metal bar .
a group of men playing brass instruments .	a group of guys play instruments outside .
two girls on the shore watch people in a boat fish .	two males , one in red and one in white playing a basketball game .
a snowboarder jumps into the air .	a snowboarder flies through the air .
a white dog with red ears is running in the snow .	a wet black dog with a red collar is in the river
a little girl and a little boy hold hands on a shiny slide .	a little girl in a paisley dress runs across a sandy playground .
kids play soccer on a field .	three boys playing soccer in a field
a group of men walk and hang onto ropes .	a group of men play a college football game .
a boy runs past a group of people with balloons in a race .	a boy runs in a race while onlookers watch .
a dog is leaping through the grass .	a dog running through the water .
a man jumps off of one rooftop onto another .	a young man jumps from one balcony to another .
a black person in black and red is sleeping on a bench with an open black umbrella .	a man sitting up taking a nap on a park bench with an open umbrella protecting him from the sun .
one child pulls another , sitting in a red wagon , along the sand .	a young boy pulls another boy wearing a silly hat in a radio flyer wagon .
a black dog lays on a grassy lawn covered in leaves .	a black dog lays in the grass and looks towards the camera .
a dog laying down on a green cushion .	a brown dog laying on a green cushion .
the black and white dog runs through the grass .	three black and white dogs running through a watery field .
a brown dog plays in the snow .	a brown dog plays with the hose .
a brown dog sniffing at the fence of a brown bull .	a brown dog is by a fence where a brown cow is .
two black dogs are playing on the grass .	two black dogs and one white dog interact .
the skateboarder does a trick on a ramp .	the skateboarder gets to the top of the ramp .
someone is splashing through ankle-high sun-lit water .	a girl wading through water in a lake .
a boy is running towards a seagull on a beach .	a boy running through surf on a beach .
two puppies playing with a plastic bag .	two dogs playing in a yard .
an owl has its wings up and widespread during the day .	the bird has its wings spread as it flies .
a man in a blue cap is sitting on a stool under a tree .	a dog standing on a beach with a ball nearby .
a girl in a tie dye hat has a butterfly on her hand .	a girl in a colorful hat has a strange creature resting on her hand .
a woman sings into a microphone by a guy playing a guitar .	a woman sings into a microphone with a guitar player in the background .
three sheep graze on the grassy field with a dog walking behind them .	a small group of goats in the grass with a black and white dog in the backgroud .
a cyclist is making his bike jump between two rocks .	a man jumps his bicycle in the air between two rocks .
a man with a grey beard rides his bike on the beach of the ocean .	a spotted dog stands on his hind legs to catch a ball on the beach .
a man in a black suit is surfing along a crashing wave .	a surfer wearing a black wet suit is riding a a white wave in the ocean .
a young girl with a pink hat on with a yellow building in the background .	a young girl in a pink dress with something in her hand .
a girl in a pink dress rides her bike along a white picket fence .	a girl in a red dress rides her bike in front of a white fence .
a brown furry animal stands behind some plants .	a dog pants while standing in the woods .
a boy wearing a red shirt runs along a beach .	a boy wearing a red sweater runs along a colorful beach .
several people in a crowd , some with their arms raised .	many people have arms lifted in a crowd .
a brown and white dog is running on the grass .	a brown and white dog running crazily through the grass .
a child in a red shirt is using a black wake board to splash over a beach wave .	a man in a rowboat is rowing across blue water .
a dog jumps over a chain .	a dog jumps down a flight of stairs .
the tan and white dog is running in the field .	the brown and white dogs run through the field .
three little girls are sitting on the grass .	two poodles are running through the snow .
two mountain climbers stand on the top of a mountain looking around .	two mountain climbers stand on the ridge of a tall , snowy mountain .
a dog jumps into the pond .	the skateboarder jumps into the air .
a brown dog runs towards the camera on a dirt trail with mountains in the background .	a brown dog runs toward the camera down a rocky trail through the brush with mountains in the background .
a golden retriever jumping off a wood porch .	a golden retriever is jumping off a wooden porch
a girl sliding down a pole	a young girl sliding down a black pole .
dog is jumping down a ramp .	a girls is jumping in the sand .
three dogs are playing in the white snow .	three dogs play with a frisbee in a snowy field .
the dog plays in the park .	the dog leaps over the fence in the park .
a woman pointing at a geyser .	women pointing at a geyser .
a dog is running through some water .	a black dog is running through the snow .
two teenage girls , one is smiling .	a little girl on a kid swing .
two girls arm wrestling , while another looks on .	two girls arm wrestle while a third girl in a pink shirt and glasses watches .
a young girl in a pink jacket walking down a gravel path in a wooded area .	a little girl in a pink coat is walking down a dirt road
a dog runs through a very wooded area .	a dog running through a creek .
a skateboarder grinds a rail .	a skateboarder uses a ramp .
two birds interacting in the grass	two dogs play with each other outdoors .
a woman holds a fat baby with sunglasses and a denim hat .	a small baby wearing sunglasses sits on an adult 's lap .
four dogs stand in the snow .	four dogs playing in the snow .
a black dog asleep in a car .	a black and tan dog sleeps in the car .
a white dog and a black and white dog are running through the grass .	a blurred image of a black and white dog running through the grass .
brown and black dogs on snow , showing teeth and barking at each other .	a black dog fighting with a brown dog in the snow .
two hikers stand at the top of a snowy mountain .	two mountain climbers stand on the top of a mountain looking around .
a man in plaid shirt hits a tree with an axe .	a man in a plaid shirt uses a tool by a tree .
two dogs run through grass .	two brown dogs run through the grass .
two young soccer players race to the goal .	two soccer players rush to kick the ball .
a man running on a track .	a man running track
a yellow dog catches a frisbee in mid air .	a yellow dog catches a red frisbee .
two children in a field of red flowers .	two kids are playing in a field of red flowers .
a young men jumps off rocks into a lake .	a young man in red swimming trunks jumped off a large rock into the water .
a small black dog is in the grass .	a black dog is running in the grass .
a lady dressed in a kimono is looking at the camera .	two girls dressed in black are sitting in a room making suggestive poses at the camera .
the black and white dog is running through the ocean .	the brown and white dog is running though the brush-land .
a group of people are firing up a hot air balloon .	a large group of people riding brown and white horses .
a black dog is running along the beach .	a dog is running on the beach .
a black dog walking through splashing water in a rocky creek .	a black dog splashes through greenish water .
two girls taking a picture of themselves	two blonde girls are taking a picture of themselves .
a dog runs through the water while holding a stick in its mouth .	a dog running along a fence on a dirt track .
children play fight with swords .	a child and parent pet a horse .
a man is wind sailing in the ocean .	a dog is running through the ocean .
a man is skating down a set of stairs .	the man is skiing down a snowy hill .
three dogs racing on a dirt track	cars racing on a dirt track
a man and a small girl floating on an innertube .	a young girl wearing a bikini in an inner tube .
a group of dogs run through the snowy field .	a dog runs through a snowy field .
two women walking down the street	a man walking two dogs down a street .
two blond women sit in grass with a small dog .	two blonde young women hang out in the grass with a brown dog .
two people holding hands and walking in a field .	two men walking past a mural of a car .
the skier is doing a flip through some trees	person on skis upside down caught between two trees
the black dog is running through the grass .	a black dog running through water .
a brown dog chases a frisbee	a brown dog squating on grass .
a dog plays in the water .	a dog plays in the snow .
a lady with a yellow outfit is in the air above the bed in a yellow room .	a dog with a red leash still attached chases over the grass toward a tennis ball .
a person is climbing a snowy mountain .	the person is in the snowy mountains .
a little girl in a colorful dress is playing with a blue and red soccer ball .	young girl in blue dress stepping over a soccer ball .
woman in red overalls standing on the sidewalk .	a woman in red overalls stands on sidewalk .
a dog is running through a backyard full of leaves .	three dogs run through a field .
a man in a checked shirt stands next to a large wooden bowl .	an older man is standing next to a display of wooden trays .
two puppies playing around in the grass	two puppies play in the grass
a football player kicks the ball .	an oklahoma football player attempts to kick the ball .
a light-colored dog runs through the grass .	a dog runs through the grass .
two black and white dogs are playing together outside .	two children and a black dog are playing out in the snow .
three dogs running through water .	a black dog running through water .
brown dog jumping over a bar on a grassy field .	brown dog jumping over a hurdle .
a woman sits alone against a brick wall	a woman is walking with a red bag .
the black and white race car is going fast around the track while fans watch nearby .	a black and white rally car takes the turn .
a boy wearing red shoes is climbing in a tree .	a child wearing red shoes climbing a tree .
a skier is jumping in the air over a snowfield near a mountain range .	a woman is sitting near a flower bed overlooking a tunnel .
sports team poses on field with crowd in the background .	a sports team poses on the field .
these children are playing on a trampoline outdoors .	four children are playing on a trampoline .
a brown dog carrying a stick in its mouth .	a dog swimming with a stick in its mouth .
a young woman leans over her plate at a meal .	a young woman , topless except for paint or mud .
the dogs are playing in the snow .	two dogs playing on the shore .
a young boy in red swim trunks is jumping into a pool .	a dog is being squirted with a hose as it jumps into a paddling pool .
a person climbs up a snowy hill while their dog follows .	a person climbs a snowy hill while a black dog follows .
a brown dog sits on the beach .	a dog running on the beach
a man who is resting his head on his hand .	a woman resting her face on her hand .
a dog in a car .	a black and tan dog sleeps in the car .
a black and white dog is running on the beach .	a white dog is running on sand .
scuba diver submerged in water .	the scuba diver is underwater .
the man is riding a bike down a dirt hill .	a trick bicyclist grinds down a handrail .
a large gray dog is playing in the deep snow .	four dogs playing in the snow .
a man riding his bike on the beach by the ocean .	a man walking his cow down the side of the road .
two dogs are running on the grass in front of the trees .	a brown dog is running on the grass in front of some trees .
a dog in in a car .	a dog is biting a mop .
a brown dog is running across the grass with a stick in it 's mouth .	a big tan dog runs on grass with a big stick in his mouth .
child holding an object that is on fire .	a child in pink holds an object that appears to be on fire .
a dog with floppy ears walking towards the camera in the woods .	a child in front of his own reflection turning towards the camera and smiling .
two tan dogs play in the grass	a lean dog playing in tall grass .
a brown dog is splashing water everywhere by shaking the water off of itself .	a white dog is standing by a river shaking himself dry .
a young boy climbing on a rock wall	five greyhounds are racing on a sand track .
a police officer directs traffic on a city street .	a man walks toward a policeman standing in a crosswalk on a city street .
a black and white dog runs through grass .	brown and white dog running through a grassy field .
little girl jumping in water puddle	a girl jumping in a puddle .
the black and white dog is running on the grass .	a boy and a dog running on grass
a black and white dog is running on the beach .	the black and brown dog is running through the snow .
white dog outside with two people in background .	little boy coming at camera down blue slide , smiling woman in background .
a man in a red coat and hat talks to another man in red .	a man wearing a red coat with glass looks at another man .
many middle eastern people are sitting in the back of a blue truck .	a group of people are riding in the back of a truck .
person with two ski poles skiing down a snowy hill .	a person skiing down a snowy hill .
a woman is eating fish at a restaurant .	a woman eating a large fish in a restaurant .
a child and two dogs play in the water .	a child in red and blue floaties looking down at the water .
a skateboarder doing a trick on a stone wall .	a skateboarder riding up to a slope .
a toddler in a beige suit is smiling whilst playing in the snow .	a baby girl in a brown snowsuit plays in the snow .
people are standing on an escalator moving up .	people ride up an escalator .
a woman in a dress raises her arm over her head .	a woman looking upward with her hand above her head .
three little girls are sitting on the grass .	three little children are sitting in the grass .
the white and brown-spotted dog is walking through shallow water .	a white and brown dog appears to be walking on the water .
a lady is running her dog through an agility course .	trainer runs her dog through training course with green pipe
the white and brown dog is shaking its ears .	the brown dog is running across the sand .
a crowd of men wearing paper numbers on their shirts run in a race .	people with numbers on their chests are running in a pack .
a skateboarder jumps off the stairs .	a dog jumps off the stairs .
two people wearing black are standing in front of a lit up statue .	two people stand looking at a light scupture at night .
a group of people stands in front of a yellow building .	a young girl standing in front of a fountain
two dogs are playing in the snow .	two dogs are playing in a pool .
some children are raising their hands and clapping .	three children are playing soccer in the sand .
a skateboarder sliding down a stair rail .	a skateboarder doing a jump on train tracks .
two dogs play in the snow .	two dogs wrestle in the snow .
a little girl is just reaching the bottom of a playground slide	a little girl ends up at the bottom of the slide .
a man blowing a large bubble .	a man walking a large black horse .
a brown dog shaking its head .	a brown dog wearing a chain around its neck is shaking it head .
two people sit on a dock near the water .	two people sit on the end of a dock in the middle of still water .
two girls sit at a table outdoors and give their order to the waiter .	two young women sitting at an outdoor resaurant looking at menus about to place their order with the waiter standing at their table .
two dogs running together and one has a duck toy in its mouth .	a black and white dog walking through the grass with a long stick in his mouth .
the black and white dog is running on the grass .	a black and white dog swims in blue water .
hockey goal-keeper laying on the ice in front of net .	a hockey player is laying on the ice in front of the goal .
black and white dog outdoors in muddy water , with stick in mouth .	a black and white dog is running though water whilst bearing it 's teeth .
a skier wearing blue snow pants is flying through the air near a jump .	a skier stands on his hands in the snow in front of a movie camera .
a black and white dog is running on the beach .	the black and white dog is running in the damp sand .
the brown dog is running along a grassy pathway .	a brown dog is running along a grassy stretch divided by strings .
the girl is wearing a blue striped shirt and rollerblades .	a man wearing a black and white shirt jumping on a dogs back
a tattooed man in black playing a white guitar and singing .	a woman in a black and white coat and earmuffs .
a dog running along the beach .	boy and girl running along the beach .
a black dog with a red collar sitting in the sand .	a black and white dog is biting onto a stick in the water .
child hanging upside down from a tree swing	a girl is by a tree hanging upside-down from a swing .
a young man and woman sitting on a bench outside are kissing .	the man and woman sitting on a bench are kissing .
a brown dog is jumping up to catch a green strap in it 's mouth .	a grey dog jumps to bite a green leash .
two black-robed young men stand on the steps in front of a building .	two orthodox priests stand on the steps outside a church .
a black dog is running in the grass .	a black and a brown dog running in the grass .
two gray dogs run through a field of pink heather .	two dogs bound over a flower-covered hill .
a group of adults sit in wood lawn chairs talking , surrounded by wilderness .	group of people sitting in lounge chairs on patio looking at mountains .
a curly coated dog looking at another dog in the water .	a wooly dog on a beach looks toward another dog in the water .
a boy playing hockey lies on the ice , injured .	two soccer teams are playing , one is in white the other in red .
two black dogs are playing with an orange stuffed dog toy .	two black dogs are playing tug-of-war with an orange toy .
two brown dogs wearing collars fighting .	the brown dog is wearing a black collar .
a woman is sitting on a sidewalk with a cell phone at her ear .	a woman is riding her bicycle .
three dogs play in a grassy field .	some kids play in a field .
a small white dog climbs over a log .	a small dog steps onto a log .
a young boy plays in a red ball pit .	a laughing boy lies on a pit of blue balls .
a lean dog runs through green grass .	a brown dog and two black dogs in an overgrown grassy field .
two boys playing in water .	young boys enjoying a spray of water .
a surfer on a wave .	a surfer is riding a wave .
two dogs running through tall grass .	three dogs running through the snow .
a black dog runs across the snow .	a black dog is running across a field .
the dogs play in the snow on hind legs .	two dogs play in the snow .
a little girl and her stuffed monkey seated on a ride above the fairgrounds .	girl and large stuffed animal riding an amuseument ride over a fair .
two dogs are fighting over a red frisbee outside .	two dogs are fighting over a red frisbee that is bent in half .
three dogs are playing on grassy hill with a blue sky .	three dogs play in the grass .
two boys play with two dogs at the shore .	two boys and two dogs are playing in the sand and water at the seashore .
a brown and white dog is jumping over a yellow and red pole .	a brown and white dog is jumping over an obstacle
three little boys take a bath in a rubber bin on the grass .	three well-dressed children are sitting on a bench and smiling .
the skateboarder gets to the top of the ramp .	the skateboarder rides the pipe wall at a skater park .
a group of children playing with props	a group of children playing with a dog
a brown dog running after a a red ball .	a brown dog is running along a beach .
three women dressed up in green and shamrocks .	three women wearing plenty of green and shamrocks .
a girl in a pink jacket is walking through a large puddle .	a young boy is splashing through a puddle of water .
two men in a running contest .	dogs in a race .
a dog swimming in a lake has sunshine shining on him .	a dog swims while carrying a stick in its mouth .
a boy skateboards down the railing of some graffiti stairs	a skateboarder slides down a handrail on his feet .
a mountain climber follows the edge of the mountain .	a skier about to go down the mountain .
two dogs are running towards each other across the sand .	two dogs are running towards each other on a beach .
a skateboarder mid air with his skateboard .	teen grinding a bench on a skateboard
a black and white dog runs through the water .	black and brown dog runs through field .
two kids are walking on a path in the woods .	two children walking down a path in the woods .
a man sits on a horse with mountains in the background .	a man riding a brown horse poses in front of a mountain scene .
a biker jumps an obstacles .	a golden retreiver jumps over an obstacle .
a brown and white dog is running on the grass .	the tan and black dog is running across the grass .
a woman runs on the beach .	a dog runs across the land .
a girl dances on a stage .	a girl dances on a sidewalk .
two dogs run side-by-side on the grass .	two dogs running on grass .
one child pushes another on a swing in a playground .	a boy is pushing another boy on the swings .
two dogs are peeing at a red fire hydrant .	two dogs are urinating on the red fire hydrant .
a woman is flying through the air and landing on a bed .	a swan is flying through a body of water .
two children ride saucers down a snowy hill .	two children go sledding .
person holding stop sign to direct traffic .	a person standing on a ridge in the desert .
a brown dog biting a horse 's leg .	a dog nips at the leg of a horse .
a shirtless man rock climbs .	a man rock climbing .
a group of dogs playing	a group of dogs racing .
a rugby player in dark gear is carrying a light colored rugby ball with arm outstretched .	a brown dog splashes in the water while carrying a ball in it 's mouth .
dog running on shore beside two geese in water	a black dog running along the sandy shoreline of a body of water while two ducks swim nearby .
a small dog runs through a grassy field .	two dogs bound across the grass .
a golden colored dog jumps around in the grass while holding a stick in its mouth .	a black dog is running through the grass carrying something red in its mouth .
a child catcher reaching out his mit to catch a ball .	a boy catcher in a helmet , stretching out his gloved hand for a catch .
there is a boy wearing jeans and a baseball cap jumping in the air .	a boy , wearing a baseball cap , jumps in the air near some steps .
two beige dogs are playing in the snow .	three dogs are in the snow .
two people are walking through some water .	two girls are walking by a tree in front of a brick building .
a girl jumps rope in a parking lot .	a little girl swimming in a pool .
a girl is running on a desert path .	a young girl is talking on a cell phone .
two brown and black dogs run through the dry grass .	a brown dog runs through the grass .
a group of skiers going up a mountain	four skiers climbing snow drapped mountain .
a brown dog laying on a blue sheet .	a brown dog laying on a blue cover .
a white dog is playing with a ball on the beach .	a black and white dog is playing with a tan dog .
a dog standing near snow looking at water .	a tan dog standing on the snow looking into the woods .
a dog splashing in the water .	a dog splashes in the murky water .
a black , brown and white dog running along with a white frisbee in his mouth .	a black and white dog carries a white frisbee over the grass .
a young girl rides on a horse through a trail .	a little girl is riding a horse in the woods .
a man steers a blue boat past brightly colored houses .	a man driving a blue boat passes by some colorful houses .
a group of people are walking down the sidewalk of a big city .	a group of people are riding in the back of a truck .
a dog walks through the leaves with a large stick in his mouth .	a dog runs through the forest with something in its mouth .
a white and brown dog is laying down on a red jacket with a rodent standing on it .	a brown dog lies on its back in the grass , holding a ball in its mouth .
the dog is in the air above the grass .	the dog is laying on a bed with a blue sheet .
woman in black dress with red accessories is walking down the street .	woman in a black dress walking on the street .
young boy plays ball on the beach .	a dog plays on the beach .
a black dog is running through some water .	a man in a football uniform is running with a football during a game .
girl stands in subway waiting on something .	a girl stands in a dimly lit area .
two dogs approach each other in the grass .	two dogs face off of each other on the grass .
the man is sitting with a little girl in the park .	the man is playing with the shaggy little dog .
a large tan dog is running with a green item in its mouth	the tan dog is carrying a green squeak toy in its mouth .
white and brown dog with mouth open running on grass .	a white dog with patches of brown and black on his eye is running through green grass .
a man juggles at the beach .	a man in swim trunks is juggling on the beach
a group of people in boats racing towards the shore .	a classroom of students watching a presentation .
a person is riding a skateboard in the air above a ramp .	a biker is riding along a track element located with a wooded area .
a child pushes another child on a swing .	the boy is pushing a girl on a swing outside .
a boy skateboards down the metal handrail at night .	a brown dog runs on the sand , holding a stick .
crowd gathered in streets waving brightly colored flags .	a crowd of people are gathered in the street waving irish flags .
a person is squeezing through an opening in the rock face .	a medium sized brown dog is running through an open white wooded area .
man on green bicycle performing a trick on one wheel .	the man is doing a trick on his green bike .
dog running towards camera with a ball in its mouth .	the black and white dog swims with a brown object in its mouth .
a young girl running on the beach .	a little girl running at on the shore of a beach .
a baseball player throws the ball .	the basketball player holds the ball .
a white dog runs into a lake .	a white dog jumps into a pool .
two dogs are playing catch in a field .	two dogs are chasing each other in a yard .
a man is swinging on a rope over water .	a man in a maroon bathing suit swings on a rope on a lake .
a woman wearing large sunglasses holds newspapers in both hands .	a fat woman wearing faint blue top is blowing soap bubble .
a man doing a trick on a skateboard .	a man in mid air on a skateboard .
a young girl in swim goggles does the backstroke in a pool .	a girl does the backstroke in the pool .
a deer jumps a fence .	a deer is jumping over a fence .
a young girl dressed in a minnie mouse outfit and an older woman walking down the sidewalk .	a man wearing a white suit holding a newspaper walking through the streets .
a dog sprints across the water .	a dog jumps through water .
